,client_id,reconnections,lat_mean,lat_max,lat_min,total_msgs,out_msgs,in_msgs,lost_msgs,active_time,rtt_rmse,opt_rate,discovery_rmse,discovery_rate
0,177830201,198,2.914,5.0,0.65,1157,651,506,145,337,3.939,0.03,0.002,0.99
2,178483501,4,1.434,5.0,0.65,127,65,62,3,44,1.499,0.02,0.0,1.0
3,178885001,189,2.116,5.0,0.65,1810,974,836,138,590,2.687,0.01,0.003,0.99
4,181758601,3,1.21,5.0,0.651,530,266,264,2,199,1.302,0.0,0.0,1.0
5,182232701,1,1.186,3.0,0.65,1572,786,786,0,591,1.382,0.0,0.0,1.0
7,183533601,203,3.556,5.0,0.65,886,526,360,166,242,4.805,0.03,0.004,1.0
8,184507401,9,0.998,5.0,0.651,670,337,333,4,247,1.375,0.0,0.0,1.0
9,185892901,11,0.89,5.0,0.651,982,496,486,10,364,0.395,0.0,0.0,1.0
10,186028501,143,1.716,5.0,0.651,1754,938,816,122,592,1.661,0.0,0.004,0.99
11,186821501,198,3.232,5.0,0.65,970,559,411,148,267,4.644,0.04,0.003,0.99
12,187319101,29,3.382,5.0,0.65,138,81,57,24,38,5.195,0.04,0.0,1.0
13,187426001,164,3.808,5.0,0.651,662,394,268,126,170,5.9,0.01,0.0,1.0
14,187758401,178,2.108,5.0,0.65,1835,982,853,129,594,2.711,0.01,0.003,0.94
15,187781201,198,2.494,5.0,0.651,1456,806,650,156,462,2.995,0.01,0.003,0.99
16,189660101,200,3.475,5.0,0.65,908,538,370,168,256,4.405,0.04,0.005,0.98
17,189877301,4,1.664,5.0,0.651,502,253,249,4,190,1.994,0.0,0.0,1.0
18,192487201,1,0.65,1.0,0.65,860,430,430,0,326,0.03,0.0,0.0,1.0
19,195978501,11,1.007,5.0,0.651,699,355,344,11,254,0.608,0.0,0.0,1.0
20,196727701,1,1.061,5.0,0.65,868,434,434,0,323,1.037,0.0,0.0,1.0
21,199485101,111,3.788,5.0,0.65,442,263,179,84,110,5.905,0.07,0.006,0.98
22,199836701,201,3.71,5.0,0.65,852,499,353,146,226,5.634,0.03,0.004,0.96
23,200512301,4,0.879,5.0,0.651,1415,708,707,1,531,0.831,0.0,0.0,1.0
24,202213001,200,2.401,5.0,0.65,1541,849,692,157,486,2.941,0.02,0.0,1.0
25,202911501,199,3.632,5.0,0.65,888,515,373,142,236,5.501,0.03,0.001,0.99
26,204654801,185,2.149,5.0,0.651,1805,975,830,145,592,2.442,0.0,0.003,0.99
27,205014901,58,1.48,5.0,0.651,1071,559,512,47,372,1.838,0.0,0.0,1.0
28,206569901,184,3.793,5.0,0.65,732,438,294,144,193,5.861,0.04,0.0,1.0
29,207082401,132,1.745,5.0,0.65,1529,826,703,123,527,1.262,0.0,0.0,1.0
30,208812001,147,4.183,5.0,0.65,517,323,194,129,133,5.788,0.09,0.021,0.99
31,210350901,110,3.902,5.0,0.65,415,253,162,91,107,5.572,0.0,0.0,1.0
32,210919601,145,3.011,5.0,0.652,776,446,330,116,225,3.752,0.02,0.0,1.0
33,212667701,193,2.192,5.0,0.651,1796,978,818,160,593,2.239,0.0,0.003,0.99
34,212769701,61,2.434,5.0,0.65,432,244,188,56,140,1.961,0.01,0.0,1.0
35,214367601,3,1.345,5.0,0.65,314,158,156,2,119,1.74,0.0,0.0,1.0
36,217649401,120,1.72,5.0,0.65,1715,908,807,101,590,1.634,0.0,0.0,1.0
37,217764201,203,2.268,5.0,0.65,1602,882,720,162,509,2.714,0.01,0.003,1.0
38,218303001,163,1.852,5.0,0.65,1799,962,837,125,594,2.207,0.0,0.007,0.99
39,218688101,199,2.715,5.0,0.65,1553,856,697,159,482,3.142,0.01,0.004,0.98
40,219468301,62,1.234,5.0,0.65,1519,788,731,57,544,1.09,0.0,0.0,1.0
41,219511701,140,1.801,5.0,0.65,1578,847,731,116,530,1.913,0.01,0.0,1.0
42,219900501,209,2.614,5.0,0.65,1379,773,606,167,426,3.089,0.02,0.018,0.99
43,220699801,49,2.259,5.0,0.65,697,368,329,39,236,2.543,0.0,0.0,1.0
44,220961301,27,3.812,5.0,0.651,103,62,41,21,24,6.282,0.0,0.0,1.0
45,222570001,158,2.698,5.0,0.65,949,541,408,133,293,2.939,0.01,0.0,1.0
46,222993101,148,1.783,5.0,0.651,1745,930,815,115,595,2.164,0.0,0.004,0.98
47,223048501,202,3.517,5.0,0.65,908,535,373,162,249,4.708,0.02,0.0,1.0
48,223120401,207,2.079,5.0,0.65,1818,993,825,168,591,2.399,0.01,0.001,1.0
49,223856401,179,2.767,5.0,0.651,1164,653,511,142,350,3.233,0.01,0.002,0.99
50,224397101,206,3.045,5.0,0.65,1180,670,510,160,352,3.783,0.02,0.001,1.0
51,226600001,200,2.43,5.0,0.65,1442,799,643,156,451,3.002,0.01,0.0,1.0
52,231526101,142,1.688,5.0,0.651,1744,932,812,120,591,1.742,0.0,0.004,0.99
53,232198601,33,1.176,5.0,0.65,1556,793,763,30,565,1.246,0.0,0.0,1.0
55,235994101,1,1.632,2.0,0.65,509,255,254,1,194,1.977,0.0,0.0,1.0
56,236937001,54,4.195,5.0,0.651,182,116,66,50,47,5.756,0.08,0.034,0.98
57,240029901,132,1.682,5.0,0.65,1712,905,807,98,591,2.17,0.0,0.0,1.0
58,240989701,199,3.913,5.0,0.651,760,462,298,164,203,5.876,0.04,0.002,0.99
59,242921301,113,4.266,5.0,0.65,400,249,151,98,104,6.286,0.05,0.0,1.0
60,245740201,192,2.132,5.0,0.65,1828,993,835,158,592,2.259,0.0,0.0,1.0
61,247273001,134,2.468,5.0,0.651,962,538,424,114,305,2.626,0.02,0.0,1.0
62,248044901,35,1.168,5.0,0.651,1624,828,796,32,591,1.154,0.0,0.0,1.0
63,253529101,193,2.222,5.0,0.65,1850,990,860,130,596,3.018,0.01,0.006,0.99
64,256334601,70,2.327,5.0,0.651,573,315,258,57,181,2.608,0.01,0.0,1.0
65,257051801,1,1.104,2.0,0.651,1614,807,807,0,595,1.122,0.0,0.0,1.0
66,257872901,79,3.916,5.0,0.651,293,179,114,65,75,5.863,0.03,0.0,0.92
67,259827801,132,1.808,5.0,0.65,1564,833,731,102,519,2.17,0.0,0.0,1.0
68,261217901,77,4.247,5.0,0.652,254,164,90,74,66,4.554,0.0,0.0,1.0
69,262938201,57,3.833,5.0,0.65,214,130,84,46,55,6.045,0.0,0.0,1.0
70,263181301,72,2.965,5.0,0.651,389,225,164,61,115,3.256,0.02,0.0,1.0
71,266876301,157,2.494,5.0,0.65,1088,610,478,132,338,2.657,0.01,0.0,1.0
72,267044101,208,2.325,5.0,0.651,1823,990,833,157,591,2.793,0.01,0.005,0.99
73,267411001,203,3.598,5.0,0.65,912,532,380,152,245,5.124,0.04,0.002,1.0
74,268164901,4,1.062,5.0,0.65,993,498,495,3,366,0.882,0.0,0.0,1.0
75,268192501,181,2.113,5.0,0.65,1812,971,841,130,595,2.77,0.01,0.0,1.0
76,269306201,51,1.623,5.0,0.651,1158,602,556,46,421,1.641,0.0,0.0,1.0
77,270552801,205,2.352,5.0,0.65,1526,844,682,162,484,2.8,0.01,0.002,1.0
78,270862901,138,3.195,5.0,0.651,661,389,272,117,191,3.602,0.02,0.0,1.0
79,271207601,27,2.055,5.0,0.65,268,145,123,22,87,2.186,0.01,0.0,1.0
80,271501201,5,0.899,5.0,0.651,1208,605,603,2,449,0.872,0.0,0.0,1.0
81,271671501,186,2.965,5.0,0.65,1293,718,575,143,404,3.71,0.01,0.003,0.99
82,273687001,4,2.515,5.0,0.651,18,10,8,2,5,6.466,0.0,0.0,1.0
83,274252701,10,0.985,5.0,0.651,1607,808,799,9,595,0.756,0.0,0.0,1.0
84,275473701,1,1.077,3.0,0.903,232,116,116,0,88,1.075,0.0,0.0,1.0
85,282893001,184,2.161,5.0,0.65,1788,971,817,154,590,2.226,0.0,0.0,1.0
86,283237601,1,1.647,2.0,0.65,434,217,217,0,158,2.002,0.0,0.0,1.0
87,284492401,198,2.075,5.0,0.65,1857,1000,857,143,592,2.789,0.18,0.002,0.99
88,285373201,156,2.406,5.0,0.65,1124,627,497,130,353,2.595,0.0,0.004,0.99
89,285391201,80,4.007,5.0,0.651,272,175,97,78,71,4.382,0.0,0.0,1.0
90,287074901,170,1.872,5.0,0.651,1769,956,813,143,593,1.917,0.01,0.004,0.99
91,287392801,1,1.103,2.0,0.651,1594,797,797,0,596,1.12,0.0,0.0,1.0
92,287882201,193,2.348,5.0,0.65,1623,888,735,153,524,2.66,0.0,0.009,0.99
94,291918801,140,2.028,5.0,0.651,1378,747,631,116,456,2.109,0.01,0.0,1.0
95,294077501,155,2.247,5.0,0.65,1206,673,533,140,391,1.89,0.0,0.007,0.97
96,294851801,150,1.755,5.0,0.651,1771,945,826,119,594,2.016,0.01,0.003,0.99
97,295786301,209,2.98,5.0,0.65,1151,657,494,163,336,3.852,0.02,0.003,1.0
98,295832401,4,0.985,5.0,0.903,587,295,292,3,220,0.958,0.0,0.0,1.0
99,296967301,1,1.051,5.0,0.65,1582,791,791,0,592,1.24,0.0,0.0,1.0
100,297260101,136,3.046,5.0,0.65,707,414,293,121,208,3.172,0.01,0.0,1.0
101,298719001,176,3.919,5.0,0.651,669,406,263,143,175,5.827,0.0,0.003,0.99
102,303018401,204,2.132,5.0,0.65,1831,992,839,153,591,2.652,0.01,0.008,0.95
103,303502201,109,1.433,5.0,0.651,1683,888,795,93,583,1.449,0.01,0.0,1.0
104,305705001,187,2.055,5.0,0.65,1803,972,831,141,591,2.518,0.0,0.003,0.99
105,311266501,4,0.844,5.0,0.65,1587,795,792,3,593,0.626,0.0,0.0,1.0
106,312987901,144,1.747,5.0,0.65,1772,936,836,100,595,2.395,0.0,0.004,0.99
107,313099201,181,2.651,5.0,0.651,1473,802,671,131,468,3.479,0.01,0.004,0.98
108,313599001,48,1.907,5.0,0.65,919,481,438,43,320,1.941,0.0,0.0,1.0
109,314610001,156,2.686,5.0,0.65,983,554,429,125,295,3.197,0.01,0.005,0.99
110,316062301,189,2.449,5.0,0.65,1452,803,649,154,463,2.668,0.01,0.003,0.99
111,317049401,172,3.999,5.0,0.651,659,400,259,141,170,6.033,0.05,0.0,1.0
112,319360201,28,1.809,5.0,0.651,285,155,130,25,97,1.264,0.01,0.009,0.96
113,321259701,1,1.205,5.0,0.652,566,283,283,0,212,1.34,0.0,0.0,1.0
114,323653801,1,1.189,3.0,0.65,1592,796,796,0,591,1.386,0.0,0.0,1.0
115,323793801,198,3.356,5.0,0.651,959,559,400,159,271,4.253,0.0,0.003,0.99
116,324962901,200,2.67,5.0,0.65,1365,761,604,157,427,3.2,0.02,0.0,1.0
117,325995301,54,1.266,5.0,0.65,1659,852,807,45,590,1.18,0.0,0.0,1.0
118,328599801,213,2.202,5.0,0.65,1835,1002,833,169,595,2.544,0.01,0.0,1.0
119,328792801,199,2.141,5.0,0.65,1837,995,842,153,596,2.545,0.01,0.003,0.99
120,331554501,211,3.464,5.0,0.65,950,562,388,174,262,4.342,0.02,0.0,1.0
121,332552101,1,1.011,5.0,0.651,996,498,498,0,377,0.962,0.0,0.0,1.0
122,333665401,150,1.755,5.0,0.651,1738,932,806,126,591,1.817,0.0,0.0,1.0
123,334480801,184,2.685,5.0,0.651,1264,701,563,138,384,3.479,0.01,0.0,1.0
124,340860901,150,2.066,5.0,0.65,1410,758,652,106,458,2.761,0.01,0.006,0.98
125,340955901,187,2.857,5.0,0.65,1160,654,506,148,348,3.39,0.02,0.0,1.0
126,341378901,206,3.039,5.0,0.65,1092,628,464,164,318,3.698,0.02,0.002,1.0
127,342463701,197,2.502,5.0,0.65,1451,798,653,145,458,3.219,0.01,0.006,0.97
128,342552501,199,3.709,5.0,0.65,843,497,346,151,223,5.43,0.03,0.002,0.99
129,344386601,194,3.233,5.0,0.65,963,552,411,141,266,4.649,0.04,0.003,0.99
130,345126301,130,4.087,5.0,0.65,466,289,177,112,122,5.947,0.09,0.005,0.98
131,345397901,146,2.358,5.0,0.65,1063,595,468,127,340,2.341,0.01,0.0,1.0
132,346006301,4,1.047,5.0,0.651,1093,548,545,3,402,0.853,0.0,0.0,1.0
133,347058701,186,2.104,5.0,0.65,1792,970,822,148,592,2.351,0.0,0.0,1.0
134,348560401,207,2.135,5.0,0.651,1846,1008,838,170,596,2.386,0.0,0.003,1.0
135,348606901,201,2.08,5.0,0.65,1806,989,817,172,590,2.129,0.01,0.0,1.0
136,351329101,204,2.249,5.0,0.65,1821,990,831,159,596,2.649,0.01,0.0,1.0
137,353021501,55,2.061,5.0,0.651,513,276,237,39,161,2.897,0.01,0.0,1.0
139,356373201,159,1.951,5.0,0.65,1576,853,723,130,525,2.203,0.0,0.004,0.99
140,358732701,4,0.95,5.0,0.651,1575,789,786,3,590,0.713,0.0,0.0,1.0
141,360465001,205,2.262,5.0,0.65,1851,1000,851,149,596,2.88,0.01,0.004,0.96
142,364627301,193,2.138,5.0,0.651,1815,985,830,155,591,2.382,0.01,0.0,1.0
143,365969701,36,1.163,5.0,0.65,1628,826,802,24,592,1.279,0.0,0.0,1.0
144,368897601,147,3.393,5.0,0.651,679,401,278,123,189,4.274,0.02,0.004,0.99
145,370070501,25,0.902,5.0,0.65,1548,785,763,22,571,0.609,0.0,0.0,1.0
146,373885001,195,3.513,5.0,0.65,891,514,377,137,240,5.364,0.01,0.0,1.0
147,376055601,75,3.963,5.0,0.651,291,171,120,51,70,6.821,0.11,0.0,0.93
148,378981801,138,4.143,5.0,0.651,500,310,190,120,126,5.944,0.02,0.0,1.0
149,380010101,24,4.281,5.0,0.652,76,50,26,24,20,5.783,0.0,0.0,1.0
150,380172301,196,2.231,5.0,0.65,1802,976,826,150,590,2.661,0.01,0.0,1.0
151,385043601,137,1.729,5.0,0.65,1647,884,763,121,564,1.529,0.0,0.0,1.0
152,386517601,4,0.939,5.0,0.65,1416,709,707,2,529,0.987,0.0,0.0,1.0
154,389872601,148,1.75,5.0,0.651,1722,924,798,126,591,1.735,0.0,0.0,1.0
155,395191801,209,2.354,5.0,0.65,1551,863,688,175,493,2.571,0.01,0.0,1.0
156,395575601,210,2.74,5.0,0.651,1422,783,639,144,418,3.773,0.02,0.002,0.99
157,398396501,183,2.092,5.0,0.65,1794,970,824,146,592,2.363,0.0,0.003,0.99
