,client_id,reconnections,lat_mean,lat_max,lat_min,total_msgs,out_msgs,in_msgs,lost_msgs,active_time,rtt_rmse,opt_rate,discovery_rmse,discovery_rate
0,177830201,3,1.162,4.0,0.836,910,456,454,2,337,1.173,0.0,0.622,0.0
2,178483501,1,1.614,2.0,0.651,124,62,62,0,44,1.963,0.0,0.001,0.0
3,178885001,126,1.861,5.0,0.728,1775,911,864,47,590,3.153,0.0,1.776,0.0
4,181758601,126,3.405,5.0,0.651,720,389,331,58,199,5.661,0.0,1.829,0.0
5,182232701,125,2.169,5.0,0.723,1775,910,865,45,591,3.527,0.0,1.679,0.0
7,183533601,1,2.564,3.0,0.651,647,324,323,1,242,4.121,0.0,0.0,0.0
8,184507401,70,2.607,5.0,0.651,769,398,371,27,247,4.081,0.0,1.594,0.0
9,185892901,3,1.583,5.0,0.707,976,488,488,0,364,2.085,0.0,0.677,0.33
10,186028501,90,1.59,5.0,0.729,1728,885,843,42,592,2.448,0.0,1.837,0.0
11,186821501,83,2.703,5.0,0.752,850,444,406,38,267,4.082,0.0,1.976,0.0
12,187319101,28,3.641,5.0,0.752,150,80,70,10,38,6.324,0.0,2.081,0.0
13,187426001,111,3.278,5.0,0.651,637,341,296,45,170,5.624,0.0,1.64,0.0
14,187758401,1,1.142,2.0,0.651,1610,805,805,0,594,1.158,0.0,0.001,0.0
15,187781201,1,3.227,5.0,0.651,1218,609,609,0,462,6.055,0.0,0.0,0.0
16,189660101,1,1.155,1.0,0.65,677,339,338,1,256,1.014,0.0,0.0,0.0
17,189877301,82,2.844,5.0,0.65,622,331,291,40,190,4.504,0.0,1.882,0.01
18,192487201,3,1.658,5.0,0.687,864,432,432,0,326,2.197,0.0,0.632,0.0
19,195978501,3,4.603,5.0,1.054,691,347,344,3,254,7.961,0.0,0.805,0.0
20,196727701,4,1.668,5.0,0.651,874,437,437,0,323,2.242,0.0,0.627,0.0
21,199485101,1,0.96,1.0,0.651,306,153,153,0,110,0.629,0.0,0.025,0.0
22,199836701,1,1.521,2.0,0.651,598,299,299,0,226,1.836,0.0,0.001,0.0
23,200512301,80,1.607,5.0,0.687,1523,784,739,45,531,2.3,0.0,1.805,0.0
24,202213001,1,2.562,4.0,0.853,1300,650,650,0,486,4.382,0.0,0.202,0.0
25,202911501,1,3.563,4.0,0.65,634,317,317,0,236,5.913,0.0,0.0,0.0
26,204654801,93,2.768,5.0,0.651,1727,883,844,39,592,5.071,0.0,1.962,0.0
27,205014901,1,2.083,3.0,0.651,1004,502,502,0,372,3.392,0.0,0.0,0.0
28,206569901,125,3.766,5.0,0.723,690,379,311,68,193,6.101,0.0,1.698,0.0
29,207082401,1,1.375,2.0,0.72,1390,695,695,0,527,1.686,0.0,0.069,0.0
30,208812001,1,1.63,5.0,0.651,354,177,177,0,133,2.063,0.0,0.001,0.0
31,210350901,3,4.527,5.0,0.903,290,146,144,2,107,7.889,0.0,0.806,0.0
32,210919601,1,1.832,2.0,0.652,604,302,302,0,225,2.55,0.0,0.0,0.0
33,212667701,3,1.335,5.0,0.697,1576,788,788,0,593,1.671,0.0,0.923,0.0
34,212769701,1,1.232,2.0,0.904,368,184,184,0,140,1.167,0.0,0.253,0.0
35,214367601,3,2.067,5.0,0.65,316,158,158,0,119,2.98,0.0,1.085,0.0
36,217649401,1,1.001,2.0,0.778,1578,789,789,0,590,0.775,0.0,0.253,0.0
37,217764201,1,1.295,2.0,0.714,1360,680,680,0,509,1.473,0.0,0.063,0.0
38,218303001,5,0.953,5.0,0.65,1608,804,804,0,594,0.882,0.0,1.219,0.2
39,218688101,4,1.002,5.0,0.651,1321,661,660,1,482,0.859,0.0,1.358,0.0
40,219468301,1,1.058,2.0,0.651,1454,727,727,0,544,1.244,0.0,0.001,0.0
41,219511701,113,2.03,5.0,0.706,1589,820,769,51,530,3.312,0.0,1.814,0.0
42,219900501,1,1.074,2.0,0.73,1130,565,565,0,426,0.89,0.0,0.079,0.0
43,220699801,3,1.346,5.0,0.65,644,322,322,0,236,1.637,0.0,0.89,0.0
44,220961301,1,3.081,3.0,1.155,72,36,36,0,24,4.944,0.0,0.503,0.0
45,222570001,120,2.637,5.0,0.65,936,503,433,70,293,3.832,0.01,1.794,0.0
46,222993101,1,1.198,2.0,0.65,1566,783,783,0,595,1.354,0.0,0.0,0.0
47,223048501,1,1.174,2.0,0.904,668,334,334,0,249,1.059,0.0,0.253,0.0
48,223120401,1,0.97,1.0,0.752,1574,787,787,0,591,0.731,0.0,0.36,0.0
49,223856401,1,1.503,2.0,1.054,950,475,475,0,350,1.752,0.0,0.403,0.0
50,224397101,1,0.997,2.0,0.904,930,465,465,0,352,0.847,0.0,0.253,0.0
51,226600001,1,1.04,1.0,0.65,1200,600,600,0,451,0.834,0.0,0.0,0.0
52,231526101,3,0.79,5.0,0.714,1586,793,793,0,591,0.524,0.0,0.481,0.33
53,232198601,101,1.734,5.0,0.728,1691,861,830,31,565,2.998,0.0,1.857,0.0
55,235994101,1,2.834,3.0,1.154,509,255,254,1,194,4.56,0.0,0.504,0.0
56,236937001,1,0.987,1.0,0.651,126,63,63,0,47,0.701,0.0,0.0,0.0
57,240029901,1,1.147,2.0,0.714,1548,774,774,0,591,1.17,0.0,0.064,0.0
58,240989701,1,1.64,2.0,0.651,528,264,264,0,203,1.993,0.0,0.0,0.0
59,242921301,8,1.513,5.0,0.686,288,144,144,0,104,2.749,0.0,1.715,0.0
60,245740201,132,2.164,5.0,0.651,1803,933,870,63,592,3.354,0.0,1.743,0.0
61,247273001,3,4.235,5.0,0.871,811,407,404,3,305,7.405,0.0,0.188,0.0
62,248044901,1,0.768,1.0,0.651,1588,794,794,0,591,0.249,0.01,0.0,1.0
63,253529101,3,1.32,5.0,0.65,1600,800,800,0,596,1.656,0.0,0.632,0.0
64,256334601,1,0.651,1.0,0.651,492,246,246,0,181,0.021,0.0,0.0,0.0
65,257051801,1,1.141,2.0,0.651,1614,807,807,0,595,1.57,0.0,0.0,0.0
66,257872901,1,1.646,2.0,0.905,202,101,101,0,75,1.997,0.0,0.253,0.0
67,259827801,4,1.215,5.0,0.753,1410,705,705,0,519,1.363,0.0,0.724,0.0
68,261217901,1,1.492,4.0,0.78,176,88,88,0,66,1.984,0.0,0.129,0.0
69,262938201,52,4.073,5.0,0.819,224,125,99,26,55,7.159,0.0,1.743,0.0
70,263181301,1,3.084,3.0,0.651,308,154,154,0,115,4.943,0.0,0.0,0.0
71,266876301,3,1.552,5.0,0.729,912,456,456,0,338,1.895,0.0,0.703,0.0
72,267044101,1,0.804,2.0,0.676,1566,783,783,0,591,0.347,0.0,0.025,0.0
73,267411001,1,1.759,3.0,0.683,660,330,330,0,245,2.337,0.0,0.033,0.0
74,268164901,84,1.847,5.0,0.65,1124,578,546,32,366,3.221,0.0,2.109,0.0
75,268192501,3,0.697,5.0,0.65,1586,793,793,0,595,0.536,0.02,0.395,0.33
76,269306201,1,0.945,2.0,0.651,1104,552,552,0,421,0.786,0.0,0.001,0.0
77,270552801,1,1.32,2.0,0.65,1279,640,639,1,484,1.507,0.0,0.0,0.0
78,270862901,1,2.848,3.0,0.651,504,252,252,0,191,4.589,0.0,0.0,0.0
79,271207601,1,1.354,2.0,0.652,238,119,119,0,87,1.587,0.0,0.001,0.0
80,271501201,3,1.486,5.0,0.651,1206,603,603,0,449,1.914,0.0,0.429,0.0
81,271671501,4,1.037,5.0,0.867,1070,536,534,2,404,0.914,0.0,0.522,0.0
82,273687001,1,0.719,1.0,0.651,14,7,7,0,5,0.207,0.0,0.0,0.0
83,274252701,1,2.236,4.0,0.651,1598,799,799,0,595,3.936,0.0,0.0,0.0
84,275473701,86,4.331,5.0,0.904,359,201,158,43,88,7.528,0.0,2.248,0.0
85,282893001,1,0.982,4.0,0.689,1576,788,788,0,590,0.918,0.0,0.185,0.0
86,283237601,1,1.912,3.0,0.65,434,217,217,0,158,2.641,0.0,0.0,0.0
87,284492401,3,1.338,5.0,0.697,1610,805,805,0,592,1.677,0.0,0.566,0.0
88,285373201,111,2.669,5.0,0.707,1110,582,528,54,353,4.117,0.0,1.566,0.0
89,285391201,58,3.782,5.0,0.65,272,153,119,34,71,6.153,0.0,1.969,0.02
90,287074901,1,1.619,3.0,0.752,1574,787,787,0,593,2.704,0.0,0.101,0.0
91,287392801,1,1.233,2.0,0.651,1594,797,797,0,596,1.384,0.0,0.0,0.0
92,287882201,4,0.983,5.0,0.65,1398,699,699,0,524,0.915,0.0,1.26,0.0
94,291918801,2,1.463,5.0,0.668,1218,609,609,0,456,1.864,0.0,0.622,0.0
95,294077501,1,0.794,1.0,0.651,1038,519,519,0,391,0.289,0.02,0.001,0.0
96,294851801,4,0.95,5.0,0.673,1598,799,799,0,594,0.837,0.0,1.319,0.0
97,295786301,3,1.062,5.0,0.651,902,451,451,0,336,1.059,0.0,1.455,0.0
98,295832401,1,1.642,2.0,0.903,584,292,292,0,220,1.998,0.0,0.252,0.0
99,296967301,5,2.732,5.0,0.729,1590,795,795,0,592,5.374,0.0,0.879,0.0
100,297260101,3,1.871,5.0,0.752,562,281,281,0,208,2.568,0.0,0.425,0.0
101,298719001,1,0.651,1.0,0.651,462,231,231,0,175,0.023,0.0,0.001,0.0
102,303018401,3,1.339,5.0,0.696,1582,791,791,0,591,1.676,0.0,0.704,0.0
103,303502201,102,1.707,5.0,0.752,1719,881,838,43,583,2.768,0.0,1.662,0.0
104,305705001,52,1.317,5.0,0.728,1652,837,815,22,591,2.003,0.0,1.643,0.0
105,311266501,120,1.814,5.0,0.651,1764,911,853,58,593,2.901,0.0,1.896,0.0
106,312987901,44,1.427,5.0,0.651,1650,836,814,22,595,1.98,0.0,2.316,0.02
107,313099201,4,2.652,5.0,1.322,1249,625,624,1,468,4.507,0.0,1.164,0.0
108,313599001,102,2.088,5.0,0.651,1027,535,492,43,320,3.597,0.0,1.852,0.0
109,314610001,126,3.13,5.0,0.697,987,524,463,61,295,4.909,0.0,1.774,0.0
110,316062301,3,1.449,3.0,0.763,1232,617,615,2,463,1.814,0.0,0.584,0.0
111,317049401,119,3.902,5.0,0.697,648,347,301,46,170,6.604,0.0,2.133,0.0
112,319360201,3,2.136,5.0,0.753,260,130,130,0,97,3.116,0.0,0.425,0.0
113,321259701,2,1.85,5.0,0.669,568,284,284,0,212,2.546,0.0,0.622,0.0
114,323653801,67,1.531,5.0,0.651,1692,862,830,32,591,2.175,0.0,1.69,0.0
115,323793801,101,2.521,5.0,0.752,873,462,411,51,271,3.987,0.0,1.501,0.0
116,324962901,1,3.399,5.0,0.714,1124,562,562,0,427,6.278,0.0,0.063,0.0
117,325995301,2,1.344,5.0,0.812,1600,800,800,0,590,1.688,0.0,0.828,0.0
118,328599801,1,2.261,4.0,0.65,1580,790,790,0,595,3.979,0.0,0.0,0.0
119,328792801,1,1.319,3.0,0.65,1594,797,797,0,596,1.619,0.0,0.0,0.0
120,331554501,1,1.648,2.0,0.65,704,352,352,0,262,2.003,0.0,0.0,0.0
121,332552101,1,1.431,2.0,0.82,996,498,498,0,377,1.989,0.0,0.168,0.0
122,333665401,123,2.136,5.0,0.652,1756,905,851,54,591,3.351,0.0,1.659,0.0
123,334480801,3,1.326,5.0,0.752,1039,520,519,1,384,1.537,0.0,0.596,0.0
124,340860901,4,0.87,5.0,0.65,1223,612,611,1,458,0.705,0.0,0.465,0.0
125,340955901,1,3.06,4.0,1.029,936,468,468,0,348,5.103,0.0,0.378,0.0
126,341378901,1,1.129,1.0,0.903,846,423,423,0,318,0.965,0.0,0.252,0.0
127,342463701,1,1.055,4.0,0.689,1204,602,602,0,458,1.043,0.0,0.038,0.0
128,342552501,1,1.313,4.0,0.836,598,299,299,0,223,1.481,0.0,0.185,0.0
129,344386601,4,1.769,5.0,0.696,724,362,362,0,266,2.422,0.0,0.479,0.0
130,345126301,1,3.092,3.0,0.65,320,160,160,0,122,4.948,0.0,0.0,0.0
131,345397901,1,3.938,5.0,0.651,900,450,450,0,340,7.01,0.0,0.0,0.0
132,346006301,89,2.012,5.0,0.651,1209,633,576,57,402,2.544,0.0,1.82,0.0
133,347058701,83,1.56,5.0,0.697,1689,867,822,45,592,2.25,0.0,1.791,0.0
134,348560401,1,0.983,4.0,0.653,1604,802,802,0,596,0.928,0.0,0.002,0.0
135,348606901,1,0.803,2.0,0.735,1578,789,789,0,590,0.345,0.0,0.025,0.0
136,351329101,43,1.808,5.0,0.651,1633,829,804,25,596,2.88,0.0,2.044,0.02
137,353021501,1,0.921,2.0,0.735,444,222,222,0,161,0.556,0.0,0.025,0.0
139,356373201,3,1.406,5.0,0.651,1394,697,697,0,525,1.79,0.0,0.361,0.0
140,358732701,111,1.726,5.0,0.651,1734,896,838,58,590,2.613,0.0,1.623,0.0
141,360465001,1,1.158,2.0,0.65,1592,796,796,0,596,1.24,0.0,0.0,0.0
142,364627301,62,1.522,5.0,0.697,1673,854,819,35,591,2.067,0.0,1.841,0.0
143,365969701,51,1.51,5.0,0.65,1670,841,829,12,592,2.406,0.0,1.955,0.0
144,368897601,1,1.544,2.0,0.796,509,255,254,1,189,1.833,0.0,0.145,0.0
145,370070501,1,1.153,2.0,0.651,1522,761,761,0,571,1.229,0.0,0.001,0.0
146,373885001,135,3.608,5.0,0.687,846,454,392,62,240,5.73,0.0,1.965,0.0
147,376055601,1,0.984,1.0,0.651,194,97,97,0,70,0.684,0.01,0.0,0.0
148,378981801,115,3.862,5.0,0.651,512,287,225,62,126,6.707,0.01,1.824,0.01
149,380010101,18,3.736,5.0,0.651,73,44,29,15,20,5.712,0.0,2.195,0.0
150,380172301,3,1.157,5.0,0.752,1566,783,783,0,590,1.24,0.0,0.586,0.0
151,385043601,83,1.733,5.0,0.697,1612,830,782,48,564,2.343,0.0,1.964,0.0
152,386517601,1,1.38,3.0,0.65,1411,706,705,1,529,1.71,0.0,0.0,0.0
154,389872601,124,1.885,5.0,0.698,1732,900,832,68,591,2.867,0.0,1.986,0.0
155,395191801,1,1.784,3.0,0.903,1310,655,655,0,493,2.94,0.0,0.253,0.0
156,395575601,1,1.405,2.0,0.714,1148,574,574,0,418,1.618,0.0,0.063,0.0
157,398396501,6,2.754,5.0,0.903,1583,793,790,3,592,5.384,0.0,1.12,0.0
159,398553001,1,0.97,1.0,0.65,1586,793,793,0,595,0.734,0.0,0.0,0.0
161,400578401,1,1.133,2.0,0.652,826,413,413,0,309,0.99,0.0,0.001,0.0
162,401584801,128,2.157,5.0,0.651,1808,933,875,58,595,3.342,0.0,1.818,0.0
163,401846601,135,2.706,5.0,0.707,1025,548,477,71,312,4.111,0.0,1.868,0.0
164,402248101,1,1.239,2.0,0.903,1578,789,789,0,595,1.394,0.0,0.253,0.0
166,406566101,3,2.724,5.0,0.834,1598,799,799,0,593,5.347,0.0,1.035,0.0
167,406603701,2,1.324,5.0,0.651,1592,796,796,0,596,1.66,0.0,0.622,0.0
168,408721401,127,2.42,5.0,0.752,1160,616,544,72,375,3.592,0.0,1.887,0.0
169,408855301,131,2.58,5.0,0.784,1381,719,662,57,441,4.017,0.0,1.836,0.0
170,409305601,112,2.384,5.0,0.65,1044,554,490,64,334,3.529,0.0,1.895,0.01
171,409319701,102,1.897,5.0,0.696,1757,897,860,37,592,3.172,0.0,1.668,0.0
172,409470301,1,0.804,2.0,0.735,1582,791,791,0,590,0.347,0.0,0.025,0.0
173,410577001,1,0.998,2.0,0.652,1618,809,809,0,595,0.769,0.0,0.001,0.0
174,410979301,1,1.027,2.0,0.688,1414,707,707,0,532,0.813,0.0,0.037,0.0
175,411238201,122,2.242,5.0,0.696,1652,851,801,50,539,3.574,0.0,1.652,0.0
176,412116801,1,2.144,2.0,0.82,410,205,205,0,152,3.001,0.0,0.169,0.0
177,412341901,19,1.151,5.0,0.65,834,420,414,6,300,1.977,0.0,1.374,0.05
179,416619601,1,1.292,4.0,0.652,586,293,293,0,221,1.398,0.0,0.002,0.0
180,416927301,1,0.96,2.0,0.77,338,169,169,0,121,0.618,0.0,0.025,0.0
181,417545801,1,1.0,2.0,0.688,1610,805,805,0,594,0.774,0.0,0.037,0.0
182,417865101,3,2.2,5.0,0.819,220,110,110,0,82,3.218,0.0,0.92,0.0
183,418308401,1,1.0,4.0,0.73,1506,753,753,0,560,0.954,0.0,0.08,0.0
184,418401701,3,1.334,5.0,0.65,1580,790,790,0,594,1.674,0.0,0.608,0.0
185,419089101,1,1.13,1.0,0.752,844,422,422,0,319,0.967,0.0,0.101,0.0
186,421152101,117,2.37,5.0,0.697,1120,590,530,60,359,3.655,0.0,1.781,0.0
187,423938701,87,2.006,5.0,0.752,1259,654,605,49,424,2.779,0.0,1.921,0.0
188,424387101,1,3.046,3.0,1.656,448,224,224,0,166,4.86,0.0,1.005,0.0
189,428923101,5,0.935,5.0,0.65,326,164,162,2,121,1.476,0.83,0.965,0.2
190,430884601,77,1.526,5.0,0.697,1732,880,852,28,593,2.459,0.0,1.752,0.0
192,431390701,1,2.962,3.0,1.154,438,219,219,0,167,4.741,0.0,0.503,0.0
193,431815001,1,0.805,3.0,0.735,1556,778,778,0,590,0.344,0.0,0.025,0.0
195,433299001,107,3.86,5.0,0.752,523,285,238,47,130,6.71,0.0,1.647,0.0
197,435199201,86,2.051,5.0,0.651,1175,611,564,47,396,2.865,0.0,1.672,0.0
198,435713701,1,1.159,2.0,0.903,1580,790,790,0,593,1.241,0.0,0.253,0.0
199,436351801,1,0.97,1.0,0.696,1586,793,793,0,594,0.732,0.0,0.046,0.0
200,436895901,1,2.26,4.0,0.853,1590,795,795,0,590,3.972,0.0,0.202,0.0
201,437307501,1,1.63,2.0,0.651,144,72,72,0,50,1.988,0.0,0.001,0.0
202,437657601,4,1.347,5.0,0.723,646,323,323,0,242,1.704,0.0,1.72,0.0
203,440385601,1,1.533,3.0,0.752,1585,793,792,1,594,2.661,0.0,0.101,0.0
205,440756201,1,1.0,2.0,0.652,1566,783,783,0,594,0.774,0.0,0.001,0.0
206,442098401,1,1.319,3.0,0.701,1592,796,796,0,592,1.615,0.0,0.05,0.0
