,client_id,reconnections,lat_mean,lat_max,lat_min,total_msgs,out_msgs,in_msgs,lost_msgs,active_time,rtt_rmse,opt_rate,discovery_rmse,discovery_rate
0,177830201,52,1.384,5.0,0.65,971,505,466,39,337,1.589,0.0,0.0,1.0
2,178483501,30,2.866,5.0,0.65,155,91,64,27,44,3.563,0.0,0.0,1.0
3,178885001,88,1.481,5.0,0.65,1691,873,818,55,590,2.013,0.01,0.0,1.0
4,181758601,84,2.411,5.0,0.651,644,347,297,50,199,3.686,0.02,0.005,0.99
5,182232701,18,0.949,5.0,0.65,1591,803,788,15,591,0.774,0.0,0.0,1.0
7,183533601,4,0.959,5.0,0.651,652,327,325,2,242,1.088,0.0,0.0,1.0
8,184507401,86,2.136,5.0,0.651,773,414,359,55,247,3.164,0.01,0.0,1.0
9,185892901,10,1.368,5.0,0.651,983,495,488,7,364,1.576,0.0,0.0,1.0
10,186028501,11,0.827,5.0,0.65,1604,806,798,8,592,0.522,0.0,0.0,1.0
11,186821501,89,2.166,5.0,0.651,840,450,390,60,267,2.997,0.01,0.006,0.97
12,187319101,38,3.639,5.0,0.65,150,90,60,30,38,6.107,0.05,0.0,1.0
13,187426001,19,1.45,5.0,0.651,484,249,235,14,170,1.684,0.01,0.0,1.0
14,187758401,93,1.408,5.0,0.65,1728,897,831,66,594,1.87,0.01,0.0,0.97
15,187781201,89,1.5,5.0,0.651,1328,697,631,66,462,1.898,0.01,0.0,1.0
16,189660101,1,2.784,4.0,0.65,677,339,338,1,256,4.655,0.0,0.0,1.0
17,189877301,92,2.595,5.0,0.65,612,341,271,70,190,3.387,0.02,0.006,0.99
18,192487201,1,2.406,4.0,0.651,860,430,430,0,326,4.135,0.0,0.0,1.0
19,195978501,11,1.559,5.0,0.809,699,355,344,11,254,1.696,0.0,0.011,0.91
20,196727701,28,1.196,5.0,0.65,899,461,438,23,323,1.084,0.0,0.0,1.0
21,199485101,66,2.791,5.0,0.651,381,218,163,55,110,3.19,0.01,0.0,1.0
22,199836701,87,2.278,5.0,0.65,713,385,328,57,226,3.364,0.02,0.009,0.95
23,200512301,67,1.315,5.0,0.65,1490,771,719,52,531,1.496,0.0,0.0,1.0
24,202213001,17,0.995,5.0,0.651,1318,666,652,14,486,0.82,0.0,0.0,1.0
25,202911501,1,2.899,4.0,0.65,634,317,317,0,236,4.823,0.0,0.0,1.0
26,204654801,83,1.349,5.0,0.651,1688,873,815,58,592,1.804,0.01,0.009,0.98
27,205014901,1,2.832,5.0,0.651,1004,502,502,0,372,5.589,0.0,0.0,1.0
28,206569901,90,2.533,5.0,0.65,619,344,275,69,193,3.121,0.02,0.0,1.0
29,207082401,62,1.29,5.0,0.651,1457,756,701,55,527,1.08,0.0,0.0,1.0
30,208812001,1,3.634,4.0,1.321,354,177,177,0,133,5.976,0.0,0.0,1.0
31,210350901,8,1.036,5.0,0.65,295,151,144,7,107,0.429,0.0,0.0,1.0
32,210919601,87,2.342,5.0,0.652,720,388,332,56,225,3.477,0.02,0.004,0.99
33,212667701,14,1.113,5.0,0.65,1585,799,786,13,593,1.116,0.0,0.0,1.0
34,212769701,6,1.789,5.0,0.651,373,189,184,5,140,2.172,0.0,0.0,1.0
35,214367601,89,3.293,5.0,0.65,425,244,181,63,119,5.086,0.07,0.0,1.0
36,217649401,88,1.458,5.0,0.65,1695,876,819,57,590,1.98,0.01,0.0,1.0
37,217764201,5,1.57,5.0,0.65,1364,684,680,4,509,1.869,0.0,0.0,1.0
38,218303001,23,0.918,5.0,0.65,1624,822,802,20,594,0.65,0.0,0.0,1.0
39,218688101,92,1.646,5.0,0.65,1437,749,688,61,482,2.175,0.01,0.0,1.0
40,219468301,85,1.393,5.0,0.65,1548,811,737,74,544,1.257,0.0,0.0,1.0
41,219511701,4,0.817,5.0,0.65,1419,711,708,3,530,0.59,0.0,0.0,1.0
42,219900501,19,1.001,5.0,0.651,1154,583,571,12,426,1.034,0.0,0.0,1.0
43,220699801,1,3.826,5.0,0.651,640,320,320,0,236,6.954,0.0,0.0,1.0
44,220961301,24,3.696,5.0,0.651,104,59,45,14,24,6.54,0.0,0.0,1.0
45,222570001,86,1.944,5.0,0.65,873,469,404,65,293,2.424,0.02,0.0,1.0
46,222993101,23,0.942,5.0,0.652,1588,805,783,22,595,0.416,0.0,0.0,1.0
47,223048501,88,2.123,5.0,0.65,779,421,358,63,249,2.836,0.0,0.0,1.0
48,223120401,13,1.16,5.0,0.65,1586,799,787,12,591,0.954,0.0,0.0,1.0
49,223856401,83,1.781,5.0,0.651,1058,557,501,56,350,2.44,0.01,0.002,0.99
50,224397101,9,0.858,5.0,0.65,940,473,467,6,352,0.754,0.0,0.0,1.0
51,226600001,1,1.977,4.0,0.65,1200,600,600,0,451,3.52,0.0,0.0,1.0
52,231526101,82,1.417,5.0,0.651,1692,872,820,52,591,1.948,0.01,0.0,0.99
53,232198601,24,0.959,5.0,0.65,1551,784,767,17,565,0.937,0.0,0.0,1.0
55,235994101,91,2.605,5.0,0.666,618,345,273,72,194,3.181,0.01,0.0,1.0
56,236937001,4,1.23,5.0,0.651,131,66,65,1,47,1.771,0.02,0.0,1.0
57,240029901,68,1.243,5.0,0.65,1626,841,785,56,591,1.3,0.0,0.0,0.99
58,240989701,57,1.803,5.0,0.651,590,320,270,50,203,1.665,0.0,0.0,1.0
59,242921301,88,3.586,5.0,0.65,380,224,156,68,104,5.104,0.01,0.0,1.0
60,245740201,66,1.284,5.0,0.65,1689,867,822,45,592,1.647,0.0,0.002,0.98
61,247273001,87,2.049,5.0,0.651,917,491,426,65,305,2.512,0.01,0.0,1.0
62,248044901,91,1.361,5.0,0.651,1698,884,814,70,591,1.636,0.0,0.002,0.98
63,253529101,92,1.367,5.0,0.65,1708,889,819,70,596,1.636,0.0,0.005,0.99
64,256334601,1,4.589,5.0,0.651,492,246,246,0,181,7.927,0.0,0.0,1.0
65,257051801,95,1.384,5.0,0.651,1734,901,833,68,595,1.859,0.0,0.0,1.0
66,257872901,74,3.768,5.0,0.651,293,174,119,55,75,6.245,0.07,0.0,0.97
67,259827801,90,1.619,5.0,0.65,1530,791,739,52,519,2.329,0.01,0.003,0.99
68,261217901,31,2.308,5.0,0.652,210,118,92,26,66,2.453,0.0,0.0,1.0
69,262938201,57,3.884,5.0,0.65,213,130,83,47,55,5.918,0.04,0.0,1.0
70,263181301,1,0.915,2.0,0.651,308,154,154,0,115,0.557,0.01,0.0,1.0
71,266876301,87,1.903,5.0,0.65,1020,540,480,60,338,2.557,0.02,0.0,1.0
72,267044101,8,0.793,5.0,0.704,1573,790,783,7,591,0.259,0.0,0.0,1.0
73,267411001,22,1.267,5.0,0.651,687,351,336,15,245,1.387,0.0,0.0,1.0
74,268164901,89,1.718,5.0,0.65,1102,583,519,64,366,2.307,0.01,0.005,0.98
75,268192501,21,0.905,5.0,0.65,1604,811,793,18,595,0.549,0.0,0.0,1.0
76,269306201,91,1.689,5.0,0.651,1213,642,571,71,421,2.048,0.0,0.0,1.0
77,270552801,57,1.974,5.0,0.65,1345,696,649,47,484,2.299,0.0,0.003,0.98
78,270862901,1,4.412,5.0,0.651,504,252,252,0,191,7.695,0.0,0.0,1.0
79,271207601,16,1.685,5.0,0.651,253,134,119,15,87,2.361,0.01,0.0,1.0
80,271501201,56,1.222,5.0,0.651,1265,656,609,47,449,1.133,0.0,0.034,0.98
81,271671501,59,1.404,5.0,0.65,1146,591,555,36,404,2.07,0.0,0.0,1.0
82,273687001,5,3.737,5.0,0.651,19,11,8,3,5,7.36,0.33,0.0,1.0
83,274252701,1,1.665,4.0,0.65,1598,799,799,0,595,3.068,0.11,0.0,1.0
84,275473701,86,3.868,5.0,0.65,334,201,133,68,88,5.896,0.0,0.0,1.0
85,282893001,94,1.408,5.0,0.651,1689,881,808,73,590,1.642,0.0,0.013,0.98
86,283237601,92,2.86,5.0,0.65,558,308,250,58,158,4.443,0.03,0.002,0.99
87,284492401,87,1.387,5.0,0.651,1718,889,829,60,592,1.866,0.01,0.008,0.98
88,285373201,22,0.89,5.0,0.65,967,493,474,19,353,0.634,0.0,0.0,1.0
89,285391201,22,1.99,5.0,0.65,220,117,103,14,71,2.695,0.01,0.0,1.0
90,287074901,1,0.709,5.0,0.65,1574,787,787,0,593,0.246,0.69,0.0,1.0
91,287392801,22,1.002,5.0,0.651,1623,818,805,13,596,1.156,0.0,0.0,1.0
92,287882201,1,1.798,4.0,0.651,1392,696,696,0,524,3.248,0.0,0.0,1.0
94,291918801,15,1.274,5.0,0.651,1230,622,608,14,456,1.268,0.0,0.0,1.0
95,294077501,80,1.652,5.0,0.651,1138,598,540,58,391,2.128,0.0,0.006,0.96
96,294851801,16,1.161,5.0,0.651,1607,811,796,15,594,0.909,0.0,0.0,1.0
97,295786301,98,2.077,5.0,0.651,1017,546,471,75,336,2.429,0.01,0.0,1.0
98,295832401,90,2.348,5.0,0.65,690,381,309,72,220,2.773,0.0,0.0,1.0
99,296967301,4,0.665,5.0,0.65,1585,794,791,3,592,0.021,0.0,0.0,1.0
100,297260101,87,2.33,5.0,0.65,666,365,301,64,208,3.004,0.01,0.0,1.0
101,298719001,1,4.624,5.0,0.65,462,231,231,0,175,7.981,0.0,0.0,1.0
102,303018401,31,1.058,5.0,0.65,1614,819,795,24,591,1.263,0.0,0.0,0.97
103,303502201,65,1.498,5.0,0.651,1644,844,800,44,583,2.031,0.0,0.0,1.0
104,305705001,93,1.517,5.0,0.651,1690,878,812,66,591,1.883,0.01,0.0,1.0
105,311266501,88,1.321,5.0,0.65,1702,879,823,56,593,1.927,0.01,0.0,1.0
106,312987901,4,0.835,5.0,0.651,1591,796,795,1,595,0.69,0.0,0.0,1.0
107,313099201,80,1.519,5.0,0.65,1348,701,647,54,468,2.12,0.01,0.002,0.97
108,313599001,64,1.584,5.0,0.651,948,497,451,46,320,2.065,0.01,0.0,1.0
109,314610001,93,2.132,5.0,0.65,926,491,435,56,295,3.093,0.02,0.0,1.0
110,316062301,87,1.568,5.0,0.651,1332,701,631,70,463,1.761,0.0,0.001,0.99
111,317049401,50,2.065,5.0,0.651,516,278,238,40,170,2.634,0.01,0.0,1.0
112,319360201,78,3.452,5.0,0.651,351,205,146,59,97,4.999,0.03,0.005,0.99
113,321259701,82,2.309,5.0,0.652,667,364,303,61,212,2.988,0.0,0.005,0.98
114,323653801,90,1.423,5.0,0.65,1709,885,824,61,591,1.897,0.0,0.0,1.0
115,323793801,85,2.088,5.0,0.651,830,446,384,62,271,2.728,0.01,0.005,0.99
116,324962901,86,1.677,5.0,0.65,1223,647,576,71,427,1.703,0.01,0.0,1.0
117,325995301,16,0.888,5.0,0.65,1614,814,800,14,590,0.441,0.0,0.0,1.0
118,328599801,94,1.375,5.0,0.65,1696,883,813,70,595,1.69,0.0,0.002,0.99
119,328792801,1,2.073,5.0,0.65,1594,797,797,0,596,4.422,0.0,0.0,1.0
120,331554501,74,2.453,5.0,0.65,791,425,366,59,262,2.881,0.01,0.0,1.0
121,332552101,66,1.547,5.0,0.651,1075,563,512,51,377,1.826,0.0,0.0,1.0
122,333665401,78,1.33,5.0,0.651,1666,860,806,54,591,1.69,0.01,0.0,1.0
123,334480801,83,1.714,5.0,0.651,1156,600,556,44,384,2.723,0.0,0.0,1.0
124,340860901,1,2.478,5.0,0.65,1218,609,609,0,458,5.056,0.0,0.0,1.0
125,340955901,66,1.546,5.0,0.651,1014,533,481,52,348,1.747,0.0,0.0,1.0
126,341378901,30,1.658,5.0,0.65,878,452,426,26,318,1.831,0.01,0.0,1.0
127,342463701,14,1.24,5.0,0.651,1219,615,604,11,458,1.157,0.0,0.027,0.93
128,342552501,16,1.1,5.0,0.687,613,314,299,15,223,0.46,0.0,0.0,1.0
129,344386601,77,2.044,5.0,0.65,826,435,391,44,266,3.16,0.01,0.0,1.0
130,345126301,93,3.308,5.0,0.65,432,252,180,72,122,4.64,0.02,0.0,1.0
131,345397901,55,1.435,5.0,0.651,966,504,462,42,340,1.677,0.0,0.0,1.0
132,346006301,4,0.847,5.0,0.651,1093,548,545,3,402,0.664,0.0,0.0,1.0
133,347058701,56,1.131,5.0,0.651,1637,840,797,43,592,1.217,0.0,0.0,1.0
134,348560401,59,1.158,5.0,0.651,1672,860,812,48,596,1.188,0.0,0.0,1.0
135,348606901,52,1.729,5.0,0.65,1633,840,793,47,590,1.926,0.0,0.0,1.0
136,351329101,89,1.388,5.0,0.651,1672,875,797,78,596,1.296,0.0,0.0,1.0
137,353021501,78,2.633,5.0,0.651,549,299,250,49,161,4.027,0.01,0.0,1.0
139,356373201,1,2.267,5.0,0.65,1390,695,695,0,525,4.726,0.0,0.0,1.0
140,358732701,4,0.803,5.0,0.65,1575,789,786,3,590,0.554,0.0,0.0,1.0
141,360465001,1,2.075,5.0,0.65,1592,796,796,0,596,4.424,0.0,0.0,1.0
142,364627301,93,1.391,5.0,0.65,1707,885,822,63,591,1.876,0.0,0.0,1.0
