,client_id,reconnections,lat_mean,lat_max,lat_min,total_msgs,out_msgs,in_msgs,lost_msgs,active_time,rtt_rmse,opt_rate,discovery_rmse,discovery_rate
0,177830201,328,4.313,6.0,0.844,1307,781,526,255,337,5.225,0.03,0.056,0.99
2,178483501,49,3.633,5.0,0.783,177,110,67,43,44,5.339,0.06,0.003,0.98
3,178885001,4,1.258,6.0,0.887,1577,789,788,1,590,0.72,0.0,0.0,1.0
4,181758601,209,4.487,6.0,0.885,764,472,292,180,199,5.68,0.02,0.004,0.99
5,182232701,98,2.049,6.0,0.974,1701,883,818,65,591,2.16,0.01,0.003,0.94
7,183533601,260,4.627,6.0,0.965,953,583,370,213,242,5.72,0.05,0.005,0.98
8,184507401,268,4.684,6.0,0.792,969,596,373,223,247,5.783,0.04,0.003,0.99
9,185892901,357,4.658,6.0,1.373,1400,842,558,284,364,3.544,0.02,0.002,1.0
10,186028501,431,4.003,6.0,1.079,2128,1226,902,324,592,3.841,0.02,0.002,1.0
11,186821501,289,4.542,6.0,0.699,1071,650,421,229,267,5.576,0.05,0.009,0.98
12,187319101,45,4.229,6.0,0.849,155,97,58,39,38,6.201,0.08,0.0,1.0
13,187426001,219,5.648,7.0,2.02,725,449,276,173,170,4.782,0.04,0.0,1.0
14,187758401,141,2.1,6.0,0.831,1768,945,823,122,594,1.666,0.01,0.0,0.95
15,187781201,388,4.074,6.0,0.908,1685,996,689,307,462,4.85,0.04,0.005,1.0
16,189660101,275,4.5,6.0,0.78,984,613,371,242,256,5.74,0.05,0.005,0.98
17,189877301,208,4.679,6.0,0.675,728,457,271,186,190,5.907,0.05,0.006,0.99
18,192487201,1,1.127,2.0,0.757,860,430,430,0,326,0.012,0.0,0.0,1.0
19,195978501,287,4.695,6.0,0.924,1014,631,383,248,254,5.589,0.05,0.003,0.99
20,196727701,320,4.517,6.0,0.696,1242,753,489,264,323,5.216,0.05,0.004,0.99
21,199485101,130,4.569,6.0,0.915,444,282,162,120,110,5.234,0.03,0.0,1.0
22,199836701,246,4.536,6.0,0.714,870,544,326,218,226,5.664,0.03,0.0,0.96
23,200512301,307,3.534,6.0,0.717,1747,1011,736,275,531,2.622,0.01,0.002,1.0
24,202213001,3,1.218,5.0,0.843,1304,652,652,0,486,0.718,0.0,0.0,1.0
25,202911501,256,4.391,6.0,0.764,926,572,354,218,236,5.918,0.01,0.003,0.99
26,204654801,43,1.88,6.0,0.951,1625,833,792,41,592,0.644,0.01,0.0,1.0
27,205014901,238,3.733,6.0,1.221,1269,739,530,209,372,2.842,0.01,0.0,1.0
28,206569901,211,4.373,6.0,0.824,738,465,273,192,193,5.048,0.06,0.008,0.99
29,207082401,384,3.93,6.0,0.686,1833,1078,755,323,527,3.729,0.03,0.002,0.99
30,208812001,1,1.239,4.0,0.887,354,177,177,0,133,1.153,0.01,0.0,1.0
31,210350901,122,4.504,5.0,0.862,413,265,148,117,107,4.922,0.0,0.005,0.98
32,210919601,288,5.93,7.0,2.212,954,589,365,224,225,4.711,0.04,0.003,1.0
33,212667701,395,3.681,6.0,0.84,2025,1180,845,335,593,3.308,0.02,0.01,0.98
34,212769701,161,4.792,6.0,0.818,535,344,191,153,140,4.969,0.0,0.0,1.0
35,214367601,134,4.457,6.0,0.807,454,289,165,124,119,5.404,0.0,0.0,1.0
36,217649401,385,3.573,6.0,0.72,2024,1173,851,322,590,3.703,0.01,0.004,0.99
37,217764201,367,3.772,6.0,0.721,1795,1046,749,297,509,4.12,0.03,0.003,0.99
38,218303001,405,3.678,6.0,0.975,2089,1204,885,319,594,3.972,0.01,0.002,1.0
39,218688101,54,1.705,6.0,0.934,1371,711,660,51,482,0.74,0.0,0.0,1.0
40,219468301,355,3.729,6.0,0.754,1860,1081,779,302,544,3.414,0.02,0.0,1.0
41,219511701,335,3.379,5.0,0.707,1795,1042,753,289,530,3.375,0.01,0.006,0.99
42,219900501,374,4.104,6.0,0.892,1554,938,616,322,426,4.371,0.02,0.005,0.99
43,220699801,256,4.386,6.0,0.824,928,575,353,222,236,5.773,0.01,0.007,0.99
44,220961301,30,5.004,6.0,1.324,102,65,37,28,24,5.606,0.0,0.008,0.97
45,222570001,322,4.724,6.0,1.098,1118,705,413,292,293,5.397,0.01,0.0,1.0
46,222993101,317,3.354,6.0,1.097,1911,1099,812,287,595,2.4,0.01,0.002,1.0
47,223048501,276,4.518,6.0,0.784,973,609,364,245,249,5.582,0.02,0.003,1.0
48,223120401,416,3.741,6.0,0.873,2071,1202,869,333,591,3.286,0.01,0.003,1.0
49,223856401,42,2.013,6.0,1.009,993,516,477,39,350,0.803,0.0,0.0,0.98
50,224397101,383,4.678,6.0,0.846,1358,847,511,336,352,5.776,0.06,0.002,1.0
51,226600001,393,4.034,6.0,0.861,1663,992,671,321,451,4.809,0.03,0.0,1.0
52,231526101,315,3.419,6.0,1.186,1938,1105,833,272,591,2.695,0.01,0.003,0.99
53,232198601,412,3.563,5.0,0.686,1988,1172,816,356,565,3.659,0.02,0.002,1.0
55,235994101,221,4.762,6.0,0.765,749,475,274,201,194,5.868,0.06,0.003,0.99
56,236937001,55,4.607,6.0,1.434,180,117,63,54,47,2.908,0.0,0.0,1.0
57,240029901,376,3.391,6.0,0.818,1987,1149,838,311,591,3.619,0.01,0.003,0.99
58,240989701,232,5.009,6.0,1.377,785,495,290,205,203,4.947,0.03,0.002,0.99
59,242921301,125,4.977,6.0,0.784,399,261,138,123,104,4.046,0.0,0.0,1.0
60,245740201,250,2.762,5.0,0.911,1887,1051,836,215,592,2.232,0.02,0.001,1.0
61,247273001,342,4.913,6.0,1.122,1187,746,441,305,305,5.296,0.0,0.001,1.0
62,248044901,400,3.574,6.0,0.727,2041,1193,848,345,591,3.383,0.01,0.003,0.99
63,253529101,317,3.354,6.0,1.066,1942,1114,828,286,596,2.381,0.0,0.004,0.99
64,256334601,214,4.982,6.0,1.196,722,459,263,196,181,5.387,0.08,0.003,0.99
65,257051801,404,3.801,6.0,1.114,2114,1210,904,306,595,3.715,0.01,0.002,1.0
66,257872901,96,5.303,7.0,1.978,321,196,125,71,75,5.316,0.1,0.005,0.91
67,259827801,426,3.972,6.0,0.823,1925,1127,798,329,519,3.547,0.01,0.004,1.0
68,261217901,56,5.364,7.0,2.36,238,143,95,48,66,3.143,0.03,0.003,0.98
69,262938201,62,4.618,6.0,0.737,212,135,77,58,55,5.329,0.0,0.0,1.0
70,263181301,1,1.549,4.0,1.203,308,154,154,0,115,1.129,0.0,0.0,1.0
71,266876301,317,4.265,6.0,0.869,1270,770,500,270,338,4.761,0.04,0.003,0.99
72,267044101,393,3.79,6.0,1.149,2024,1175,849,326,591,3.592,0.01,0.003,0.99
73,267411001,269,4.531,6.0,0.795,960,598,362,236,245,5.744,0.06,0.006,0.98
74,268164901,371,4.312,6.0,0.653,1443,865,578,287,366,6.023,0.04,0.004,0.99
75,268192501,388,3.509,6.0,0.709,2059,1178,881,297,595,4.076,0.02,0.007,0.98
76,269306201,409,4.464,6.0,0.69,1565,960,605,355,421,4.701,0.02,0.002,0.99
77,270552801,404,3.919,6.0,0.841,1757,1043,714,329,484,4.469,0.03,0.005,1.0
78,270862901,63,3.168,6.0,1.248,570,314,256,58,191,2.28,0.02,0.0,1.0
79,271207601,102,4.391,6.0,0.744,340,220,120,100,87,4.518,0.0,0.005,0.99
80,271501201,471,5.256,7.0,1.775,1811,1071,740,331,449,4.163,0.02,0.002,1.0
81,271671501,56,2.309,5.0,0.89,1127,588,539,49,404,1.732,0.0,0.0,1.0
82,273687001,6,4.393,6.0,1.584,20,12,8,4,5,7.051,0.0,0.0,1.0
83,274252701,389,3.64,6.0,0.708,2078,1187,891,296,595,4.028,0.01,0.005,0.99
84,275473701,105,4.977,6.0,1.011,340,220,120,100,88,5.323,0.13,0.0,1.0
85,282893001,314,3.368,6.0,1.131,1939,1101,838,263,590,2.908,0.01,0.002,0.99
86,283237601,190,4.937,7.0,1.026,655,406,249,157,158,5.942,0.08,0.0,1.0
87,284492401,399,3.577,6.0,0.674,2088,1201,887,314,592,4.022,0.03,0.006,0.98
88,285373201,3,1.262,5.0,0.802,946,474,472,2,353,0.614,0.0,0.0,1.0
89,285391201,81,4.38,6.0,0.994,275,176,99,77,71,4.668,0.0,0.005,0.99
90,287074901,1,1.144,4.0,0.765,1574,787,787,0,593,0.646,0.0,0.0,1.0
91,287392801,247,2.915,6.0,0.793,1860,1043,817,226,596,1.773,0.0,0.003,0.99
92,287882201,297,3.361,6.0,0.836,1731,992,739,253,524,3.174,0.0,0.006,0.99
94,291918801,355,3.937,6.0,0.724,1639,962,677,285,456,4.338,0.01,0.003,0.99
95,294077501,428,4.703,7.0,0.913,1565,946,619,327,391,4.99,0.06,0.002,1.0
96,294851801,1,1.421,3.0,1.007,1592,796,796,0,594,0.517,0.0,0.0,1.0
97,295786301,372,4.698,6.0,1.0,1352,820,532,288,336,5.817,0.04,0.007,0.98
98,295832401,248,4.71,6.0,0.687,865,539,326,213,220,5.878,0.1,0.005,0.99
99,296967301,405,3.615,6.0,0.719,2055,1195,860,335,592,3.702,0.02,0.001,1.0
100,297260101,224,4.352,6.0,0.676,807,502,305,197,208,5.54,0.04,0.0,1.0
101,298719001,1,1.198,5.0,0.818,462,231,231,0,175,1.1,0.0,0.0,1.0
102,303018401,52,1.49,5.0,0.755,1633,840,793,47,591,0.846,0.0,0.0,0.98
103,303502201,398,3.825,6.0,1.166,2032,1177,855,322,583,3.739,0.02,0.003,0.99
104,305705001,91,1.941,6.0,0.737,1686,876,810,66,591,1.85,0.0,0.0,1.0
105,311266501,317,3.191,6.0,0.809,1940,1108,832,276,593,2.71,0.01,0.005,0.98
106,312987901,307,3.064,6.0,0.891,1945,1099,846,253,595,3.003,0.01,0.003,1.0
107,313099201,364,3.94,6.0,0.995,1677,985,692,293,468,4.381,0.03,0.005,0.99
108,313599001,351,4.374,6.0,0.724,1267,784,483,301,320,5.882,0.03,0.004,0.99
109,314610001,23,1.598,5.0,0.841,821,421,400,21,295,0.968,0.0,0.0,1.0
110,316062301,342,3.752,6.0,0.759,1608,956,652,304,463,3.405,0.03,0.002,0.99
111,317049401,195,5.064,6.0,1.462,668,423,245,178,170,5.287,0.04,0.0,1.0
112,319360201,112,4.888,6.0,1.402,380,239,141,98,97,5.181,0.03,0.0,1.0
113,321259701,268,6.115,7.0,2.443,902,550,352,198,212,4.937,0.1,0.007,0.98
114,323653801,381,3.532,6.0,0.667,2042,1176,866,310,591,3.397,0.01,0.0,1.0
115,323793801,295,4.818,6.0,1.261,1057,656,401,255,271,5.757,0.03,0.003,1.0
116,324962901,306,3.889,6.0,1.035,1476,867,609,258,427,3.854,0.02,0.0,1.0
117,325995301,400,3.642,6.0,0.918,2071,1198,873,325,590,3.801,0.02,0.005,0.99
118,328599801,395,3.634,6.0,0.739,2018,1184,834,350,595,3.064,0.02,0.003,0.99
119,328792801,68,1.819,6.0,0.887,1683,864,819,45,596,1.749,0.0,0.0,1.0
120,331554501,281,4.437,6.0,0.782,1027,632,395,237,262,5.98,0.01,0.003,0.99
121,332552101,64,2.575,6.0,1.323,1064,561,503,58,377,1.507,0.0,0.0,1.0
122,333665401,54,2.047,7.0,0.953,1629,836,793,43,591,0.758,0.0,0.0,1.0
123,334480801,94,2.539,6.0,1.243,1136,611,525,86,384,1.375,0.0,0.0,1.0
124,340860901,413,4.156,6.0,0.731,1721,1021,700,321,458,4.884,0.05,0.003,0.99
125,340955901,305,4.239,6.0,1.043,1273,772,501,271,348,4.138,0.02,0.002,0.99
126,341378901,331,4.47,6.0,0.749,1233,753,480,273,318,5.953,0.05,0.007,0.99
127,342463701,375,4.041,6.0,0.808,1633,976,657,319,458,4.303,0.01,0.003,0.99
128,342552501,252,4.594,6.0,0.772,869,550,319,231,223,5.41,0.04,0.0,1.0
129,344386601,22,1.27,5.0,0.661,739,380,359,21,266,0.657,0.0,0.01,0.95
130,345126301,137,4.521,5.0,0.768,468,296,172,124,122,6.143,0.03,0.004,0.99
131,345397901,338,4.438,6.0,0.805,1270,787,483,304,340,4.93,0.05,0.006,1.0
132,346006301,405,4.354,6.0,1.072,1564,949,615,334,402,5.503,0.03,0.005,0.99
133,347058701,408,3.707,6.0,0.81,2028,1192,836,356,592,3.349,0.03,0.013,0.99
134,348560401,3,1.418,6.0,1.126,1608,804,804,0,596,0.62,0.0,0.0,1.0
135,348606901,245,2.74,6.0,0.828,1835,1033,802,231,590,1.535,0.0,0.002,1.0
136,351329101,393,3.695,6.0,1.089,2040,1179,861,318,596,3.794,0.01,0.002,1.0
137,353021501,182,4.522,6.0,0.854,643,403,240,163,161,5.385,0.05,0.0,1.0
139,356373201,405,3.987,6.0,1.01,1853,1099,754,345,525,3.113,0.01,0.001,1.0
140,358732701,396,3.732,6.0,1.073,2069,1181,888,293,590,4.217,0.03,0.001,1.0
141,360465001,46,1.569,5.0,0.729,1656,841,815,26,596,1.664,0.01,0.009,0.96
142,364627301,407,3.818,6.0,1.071,2073,1199,874,325,591,3.984,0.02,0.005,0.99
143,365969701,363,3.287,6.0,0.683,2013,1153,860,293,592,3.617,0.01,0.003,0.99
144,368897601,208,4.636,6.0,0.89,742,462,280,182,189,5.85,0.05,0.004,0.99
145,370070501,355,3.551,6.0,0.953,1920,1115,805,310,571,2.936,0.01,0.0,1.0
146,373885001,263,4.656,6.0,0.937,936,582,354,228,240,5.756,0.03,0.003,1.0
147,376055601,1,1.589,4.0,1.37,194,97,97,0,70,0.882,0.01,0.0,1.0
148,378981801,3,1.597,5.0,1.338,349,175,174,1,126,1.169,0.01,0.0,1.0
149,380010101,25,5.022,6.0,1.463,81,51,30,21,20,5.897,0.2,0.009,0.96
150,380172301,410,3.642,6.0,0.82,2019,1190,829,361,590,3.37,0.01,0.0,1.0
151,385043601,405,3.592,6.0,0.707,1958,1152,806,346,564,3.661,0.02,0.001,1.0
152,386517601,39,1.642,6.0,0.756,1455,744,711,33,529,1.061,0.0,0.0,1.0
154,389872601,393,3.749,6.0,0.679,2015,1169,846,323,591,3.082,0.02,0.004,0.99
155,395191801,154,2.685,6.0,1.098,1474,808,666,142,493,1.491,0.0,0.005,0.99
156,395575601,436,4.595,6.0,1.346,1707,1009,698,311,418,5.162,0.05,0.004,0.99
157,398396501,325,3.265,6.0,1.019,1941,1112,829,283,592,2.799,0.01,0.004,0.99
159,398553001,394,3.709,6.0,1.052,2030,1186,844,342,595,3.209,0.01,0.004,0.99
161,400578401,331,4.561,6.0,0.797,1203,743,460,283,309,5.908,0.04,0.002,0.99
162,401584801,398,3.509,6.0,0.844,2077,1203,874,329,595,3.684,0.01,0.003,0.99
163,401846601,327,4.498,6.0,0.75,1208,740,468,272,312,5.936,0.06,0.001,1.0
164,402248101,7,1.262,6.0,0.756,1586,795,791,4,595,0.62,0.0,0.0,1.0
166,406566101,409,3.803,6.0,0.905,2080,1205,875,330,593,3.651,0.01,0.0,1.0
167,406603701,375,3.702,6.0,0.932,2033,1169,864,305,596,3.627,0.02,0.006,0.99
168,408721401,317,4.145,6.0,0.826,1323,806,517,289,375,3.657,0.02,0.003,0.99
169,408855301,409,4.246,6.0,0.78,1679,997,682,315,441,4.609,0.03,0.002,1.0
170,409305601,353,4.363,6.0,0.827,1287,795,492,303,334,5.579,0.03,0.002,0.99
171,409319701,384,3.57,6.0,0.741,2051,1179,872,307,592,3.61,0.02,0.002,0.99
172,409470301,12,1.279,6.0,0.862,1593,802,791,11,590,0.372,0.0,0.0,1.0
173,410577001,394,3.718,6.0,1.015,2091,1202,889,313,595,3.838,0.01,0.006,0.98
174,410979301,320,3.658,6.0,0.79,1760,1026,734,292,532,2.549,0.0,0.0,1.0
175,411238201,396,3.857,6.0,0.976,1934,1125,809,316,539,4.158,0.03,0.002,0.99
176,412116801,165,4.526,6.0,0.691,604,369,235,134,152,6.323,0.06,0.0,0.92
177,412341901,1,1.274,4.0,0.924,803,402,401,1,300,0.718,0.0,0.0,1.0
179,416619601,244,4.775,6.0,0.865,863,536,327,209,221,6.196,0.07,0.004,0.99
180,416927301,140,4.889,6.0,1.351,499,308,191,117,121,6.071,0.02,0.003,0.99
181,417545801,384,3.421,6.0,0.926,2088,1188,900,288,594,4.166,0.02,0.005,0.99
182,417865101,96,5.065,6.0,1.354,315,203,112,91,82,5.283,0.0,0.005,0.99
183,418308401,403,3.661,6.0,0.712,1987,1155,832,323,560,4.036,0.02,0.003,0.99
184,418401701,347,3.273,6.0,0.773,1962,1134,828,306,594,2.948,0.02,0.0,1.0
185,419089101,331,4.544,6.0,0.815,1236,752,484,268,319,5.359,0.1,0.006,0.99
186,421152101,304,4.125,6.0,0.854,1298,777,521,256,359,4.513,0.01,0.004,0.99
187,423938701,404,4.342,6.0,1.063,1605,971,634,337,424,5.148,0.05,0.003,1.0
188,424387101,186,4.434,5.0,0.835,653,409,244,165,166,5.691,0.03,0.0,1.0
189,428923101,36,2.224,6.0,0.889,357,195,162,33,121,1.359,0.0,0.0,1.0
190,430884601,1,1.207,4.0,1.061,1608,804,804,0,593,0.473,0.0,0.0,1.0
192,431390701,176,4.537,6.0,0.909,643,394,249,145,167,6.408,0.04,0.0,0.99
193,431815001,382,3.679,6.0,0.954,2021,1159,862,297,590,3.397,0.01,0.003,0.99
195,433299001,146,4.731,6.0,1.271,520,324,196,128,130,5.814,0.06,0.01,0.96
197,435199201,25,1.37,5.0,0.68,1079,550,529,21,396,0.707,0.0,0.0,1.0
198,435713701,409,3.832,6.0,0.998,2073,1198,875,323,593,3.552,0.02,0.013,1.0
199,436351801,406,3.58,6.0,0.679,2060,1198,862,336,594,3.661,0.02,0.005,1.0
