,client_id,reconnections,lat_mean,lat_max,lat_min,total_msgs,out_msgs,in_msgs,lost_msgs,active_time,rtt_rmse,opt_rate,discovery_rmse,discovery_rate
0,177830201,6,1.94,5.0,0.937,915,459,456,3,337,1.636,0.0,0.564,0.0
2,178483501,1,1.279,2.0,0.837,124,62,62,0,44,1.091,0.0,0.018,0.0
3,178885001,3,1.567,3.0,0.979,1574,788,786,2,590,1.147,0.01,0.585,0.33
4,181758601,1,2.627,4.0,1.198,528,264,264,0,199,3.613,0.0,0.036,0.0
5,182232701,2,1.583,5.0,0.973,1574,787,787,0,591,1.096,0.0,0.372,0.0
7,183533601,1,1.869,3.0,1.108,647,324,323,1,242,1.635,0.01,0.0,0.0
8,184507401,11,1.604,6.0,0.856,672,339,333,6,247,1.124,0.0,0.808,0.09
9,185892901,6,2.246,5.0,1.376,977,491,486,5,364,1.408,0.0,1.886,0.17
10,186028501,23,1.792,6.0,1.127,1615,818,797,21,592,0.859,0.0,1.871,0.04
11,186821501,1,2.037,3.0,1.356,723,362,361,1,267,1.527,0.03,0.0,0.0
12,187319101,17,2.552,5.0,0.865,128,69,59,10,38,4.077,0.02,1.584,0.12
13,187426001,5,2.441,5.0,2.106,468,235,233,2,170,0.905,0.0,2.01,0.0
14,187758401,3,1.371,6.0,0.884,1614,807,807,0,594,0.955,0.0,1.169,0.0
15,187781201,24,1.516,6.0,0.872,1244,632,612,20,462,1.049,0.0,1.607,0.0
16,189660101,4,1.566,5.0,0.968,683,342,341,1,256,1.392,0.0,1.603,0.0
17,189877301,15,2.179,5.0,0.675,518,264,254,10,190,2.516,0.0,2.181,0.07
18,192487201,14,1.657,6.0,1.099,880,443,437,6,326,1.41,0.0,2.382,0.07
19,195978501,10,2.006,6.0,1.131,702,354,348,6,254,1.818,0.0,1.216,0.0
20,196727701,3,1.981,6.0,0.977,872,436,436,0,323,1.68,0.0,0.216,0.0
21,199485101,11,1.753,6.0,1.155,319,163,156,7,110,1.859,0.01,0.868,0.18
22,199836701,1,3.938,5.0,0.714,598,299,299,0,226,5.95,0.0,0.202,0.0
23,200512301,1,1.807,3.0,0.908,1410,705,705,0,531,1.322,0.0,0.0,0.0
24,202213001,1,1.359,5.0,0.951,1300,650,650,0,486,1.219,0.0,0.388,0.0
25,202911501,9,1.33,5.0,0.96,643,325,318,7,236,1.091,0.0,1.016,0.0
26,204654801,16,1.846,6.0,1.059,1600,806,794,12,592,1.134,0.0,2.129,0.0
27,205014901,1,2.056,2.0,1.221,1004,502,502,0,372,1.573,0.0,0.0,0.0
28,206569901,2,2.068,5.0,0.944,512,256,256,0,193,2.426,0.0,2.834,0.0
29,207082401,3,1.615,5.0,1.036,1392,697,695,2,527,0.957,0.0,0.73,0.0
30,208812001,5,1.566,5.0,0.933,361,181,180,1,133,1.876,0.0,1.938,0.0
31,210350901,13,1.874,5.0,0.871,304,156,148,8,107,2.239,0.01,1.371,0.15
32,210919601,1,3.446,4.0,2.386,604,302,302,0,225,1.974,0.0,0.0,0.0
33,212667701,16,1.516,6.0,0.808,1595,801,794,7,593,0.984,0.0,2.222,0.06
34,212769701,9,1.731,6.0,1.001,379,192,187,5,140,1.702,0.01,1.928,0.0
35,214367601,1,1.424,3.0,1.006,312,156,156,0,119,1.044,0.0,0.0,0.0
36,217649401,11,1.175,5.0,0.739,1590,799,791,8,590,0.499,0.0,1.55,0.0
37,217764201,12,1.624,6.0,0.948,1375,691,684,7,509,1.2,0.0,2.037,0.0
38,218303001,1,1.738,2.0,1.02,1600,800,800,0,594,1.509,0.02,0.253,0.0
39,218688101,1,1.654,2.0,0.921,1316,658,658,0,482,1.377,0.0,0.253,0.0
40,219468301,19,1.488,5.0,0.764,1474,745,729,16,544,0.682,0.0,1.551,0.0
41,219511701,3,1.352,5.0,0.951,1420,710,710,0,530,1.082,0.0,0.25,0.0
42,219900501,1,1.531,2.0,0.844,1130,565,565,0,426,1.304,0.02,0.253,0.0
43,220699801,1,1.727,2.0,1.067,640,320,320,0,236,1.743,0.0,0.0,0.0
44,220961301,10,2.661,6.0,1.356,83,45,38,7,24,3.365,0.25,1.878,0.1
45,222570001,4,1.737,6.0,1.178,774,387,387,0,293,1.427,0.0,0.496,0.0
46,222993101,1,2.237,2.0,1.412,1566,783,783,0,595,1.999,0.0,0.0,0.0
47,223048501,6,1.448,6.0,1.068,674,339,335,4,249,1.254,0.0,2.237,0.0
48,223120401,1,1.474,5.0,1.004,1574,787,787,0,591,0.969,0.0,0.145,0.0
49,223856401,6,2.085,6.0,1.177,960,480,480,0,350,1.801,0.0,0.864,0.0
50,224397101,1,1.476,2.0,0.905,930,465,465,0,352,0.795,0.0,0.056,0.0
51,226600001,1,1.899,2.0,1.009,1200,600,600,0,451,1.746,0.0,0.0,0.0
52,231526101,9,1.685,6.0,1.141,1592,799,793,6,591,1.109,0.0,1.055,0.11
53,232198601,1,1.124,5.0,0.831,1522,761,761,0,565,1.009,0.0,0.597,0.0
55,235994101,8,1.343,5.0,0.855,520,262,258,4,194,1.461,0.0,0.833,0.12
56,236937001,13,2.529,6.0,1.499,141,75,66,9,47,2.698,0.02,1.06,0.08
57,240029901,21,1.154,5.0,0.927,1570,794,776,18,591,0.683,0.0,1.285,0.05
58,240989701,9,2.106,6.0,1.377,538,272,266,6,203,1.443,0.0,0.891,0.0
59,242921301,16,1.731,5.0,0.784,291,152,139,13,104,1.522,0.01,1.432,0.0
60,245740201,12,1.6,5.0,0.983,1617,813,804,9,592,1.283,0.0,2.134,0.0
61,247273001,15,1.598,6.0,1.118,829,419,410,9,305,1.06,0.0,1.477,0.07
62,248044901,6,1.562,5.0,1.122,1596,799,797,2,591,1.307,0.0,0.78,0.0
63,253529101,21,1.479,6.0,1.066,1618,818,800,18,596,0.692,0.0,1.567,0.05
64,256334601,1,2.33,3.0,1.317,492,246,246,0,181,1.97,0.0,0.0,0.0
65,257051801,1,1.947,4.0,1.355,1614,807,807,0,595,1.836,0.0,0.0,0.0
66,257872901,10,3.125,7.0,2.061,213,110,103,7,75,2.21,0.03,1.133,0.0
67,259827801,11,1.523,6.0,1.032,1419,712,707,5,519,0.944,0.0,1.503,0.0
68,261217901,1,4.075,4.0,2.368,176,88,88,0,66,2.852,0.01,0.0,1.0
69,262938201,13,2.289,5.0,0.96,162,86,76,10,55,2.804,0.0,2.152,0.0
70,263181301,1,3.374,4.0,1.236,308,154,154,0,115,4.633,0.0,0.0,0.0
71,266876301,11,1.594,6.0,1.137,923,464,459,5,338,1.276,0.0,1.423,0.0
72,267044101,10,1.827,6.0,1.117,1578,792,786,6,591,1.319,0.0,1.715,0.0
73,267411001,8,1.905,6.0,1.312,671,337,334,3,245,1.934,0.0,2.307,0.0
74,268164901,5,1.427,5.0,0.905,996,499,497,2,366,1.402,0.0,1.685,0.0
75,268192501,2,1.485,5.0,0.736,1584,792,792,0,595,1.412,0.0,2.833,0.0
76,269306201,27,1.581,5.0,0.917,1134,578,556,22,421,0.969,0.0,1.436,0.0
77,270552801,7,1.444,5.0,0.885,1290,646,644,2,484,1.246,0.0,1.711,0.0
78,270862901,6,2.038,6.0,1.253,512,257,255,2,191,1.738,0.0,1.846,0.0
79,271207601,21,1.891,6.0,0.977,262,139,123,16,87,2.28,0.0,2.285,0.0
80,271501201,16,2.608,6.0,1.841,1223,616,607,9,449,1.031,0.0,2.236,0.06
81,271671501,13,1.513,5.0,1.036,1080,545,535,10,404,0.778,0.0,1.736,0.08
82,273687001,1,1.78,2.0,1.584,14,7,7,0,5,0.492,0.0,0.0,0.0
83,274252701,22,1.705,6.0,0.913,1622,820,802,18,595,1.165,0.0,1.914,0.0
84,275473701,13,1.823,5.0,1.133,248,128,120,8,88,1.922,0.02,0.772,0.08
85,282893001,11,1.495,6.0,1.2,1589,798,791,7,590,0.804,0.0,0.935,0.09
86,283237601,17,2.199,6.0,1.002,452,233,219,14,158,1.68,0.01,2.218,0.06
87,284492401,12,1.255,6.0,0.723,1621,814,807,7,592,0.739,0.0,0.746,0.08
88,285373201,27,1.542,5.0,0.984,971,498,473,25,353,1.039,0.0,1.688,0.0
89,285391201,1,3.423,4.0,0.994,192,96,96,0,71,4.74,0.0,0.0,0.0
90,287074901,1,1.979,2.0,1.328,1574,787,787,0,593,2.0,0.0,0.253,0.0
91,287392801,4,1.745,6.0,0.968,1599,800,799,1,596,1.271,0.0,0.473,0.0
92,287882201,11,1.757,6.0,0.991,1407,706,701,5,524,1.523,0.0,1.929,0.0
94,291918801,18,1.439,6.0,0.965,1237,625,612,13,456,0.864,0.0,1.896,0.06
95,294077501,5,2.174,6.0,1.568,1044,523,521,2,391,1.449,0.0,0.926,0.0
96,294851801,9,1.481,6.0,0.833,1602,804,798,6,594,0.801,0.0,0.847,0.0
97,295786301,1,3.738,5.0,1.379,898,449,449,0,336,5.112,0.0,0.378,0.0
98,295832401,3,2.119,5.0,1.241,588,294,294,0,220,2.4,0.0,1.057,0.0
99,296967301,10,1.328,6.0,0.691,1593,800,793,7,592,0.774,0.0,2.014,0.0
100,297260101,11,1.73,5.0,0.92,573,289,284,5,208,1.925,0.0,2.435,0.0
101,298719001,4,2.091,5.0,0.971,466,234,232,2,175,2.426,0.0,2.31,0.0
102,303018401,10,1.299,5.0,0.81,1591,798,793,5,591,0.928,0.0,2.269,0.0
103,303502201,4,1.695,6.0,1.269,1565,783,782,1,583,0.82,0.0,0.566,0.0
104,305705001,8,1.481,5.0,0.755,1580,793,787,6,591,1.033,0.0,1.301,0.0
105,311266501,4,1.384,5.0,0.873,1590,795,795,0,593,0.981,0.0,1.19,0.0
106,312987901,7,1.244,6.0,1.001,1598,799,799,0,595,0.95,0.0,2.014,0.14
107,313099201,9,1.524,6.0,1.171,1255,630,625,5,468,1.011,0.0,1.298,0.0
108,313599001,3,1.312,3.0,0.757,870,436,434,2,320,1.416,0.24,1.078,0.0
109,314610001,7,1.549,5.0,0.91,807,405,402,3,295,1.113,0.0,2.377,0.0
110,316062301,1,1.605,3.0,0.94,1230,615,615,0,463,1.267,0.02,0.0,0.0
111,317049401,18,1.75,6.0,1.455,477,246,231,15,170,1.17,0.9,2.096,0.06
112,319360201,1,3.895,4.0,1.753,256,128,128,0,97,4.948,0.0,0.471,0.0
113,321259701,1,3.704,4.0,2.443,566,283,283,0,212,1.979,0.0,0.0,0.0
114,323653801,9,1.425,5.0,0.719,1601,804,797,7,591,0.782,0.0,1.586,0.0
115,323793801,7,1.537,6.0,1.261,734,368,366,2,271,1.214,0.15,2.509,0.0
116,324962901,7,1.652,6.0,1.382,1132,568,564,4,427,1.17,0.0,0.807,0.0
117,325995301,8,1.447,5.0,0.932,1608,806,802,4,590,0.917,0.0,1.346,0.0
118,328599801,1,2.602,4.0,0.858,1580,790,790,0,595,3.912,0.0,0.0,0.0
119,328792801,4,1.529,5.0,0.887,1600,800,800,0,596,1.241,0.0,2.63,0.0
120,331554501,12,1.703,5.0,0.911,722,363,359,4,262,1.918,0.0,2.155,0.0
121,332552101,17,1.817,6.0,1.199,1014,514,500,14,377,0.938,0.0,1.152,0.06
122,333665401,8,2.021,7.0,1.122,1577,790,787,3,591,1.127,0.0,1.679,0.0
123,334480801,6,1.894,6.0,1.497,1042,523,519,4,384,1.148,0.0,2.06,0.0
124,340860901,1,1.136,2.0,0.696,1218,609,609,0,458,0.055,0.0,0.0,0.0
125,340955901,15,1.754,6.0,1.261,954,482,472,10,348,1.356,0.0,2.201,0.0
126,341378901,1,1.731,5.0,0.714,846,423,423,0,318,1.98,0.0,0.0,0.0
127,342463701,7,1.525,6.0,0.923,1213,608,605,3,458,1.078,0.01,1.68,0.29
128,342552501,12,1.346,6.0,0.93,611,310,301,9,223,1.08,0.01,0.934,0.08
129,344386601,7,1.424,5.0,0.845,728,365,363,2,266,1.371,0.0,2.236,0.0
130,345126301,17,1.464,5.0,0.762,338,176,162,14,122,1.617,0.0,2.101,0.06
131,345397901,11,1.36,6.0,0.835,914,460,454,6,340,1.11,0.0,1.069,0.0
132,346006301,2,1.495,6.0,1.268,1092,546,546,0,402,0.917,0.0,0.24,0.0
133,347058701,9,1.508,6.0,0.81,1582,793,789,4,592,1.116,0.0,2.107,0.11
134,348560401,18,1.691,6.0,1.233,1627,819,808,11,596,1.177,0.0,1.505,0.0
135,348606901,13,1.405,6.0,0.88,1595,801,794,7,590,1.172,0.0,1.679,0.0
136,351329101,1,1.739,4.0,1.337,1574,787,787,0,596,1.82,0.0,0.0,0.0
137,353021501,1,2.56,4.0,1.218,444,222,222,0,161,3.425,0.0,0.973,0.0
139,356373201,8,1.534,6.0,1.01,1400,702,698,4,525,0.817,0.0,1.306,0.0
140,358732701,9,1.41,6.0,1.041,1584,794,790,4,590,0.818,0.0,2.108,0.11
141,360465001,1,2.597,4.0,0.729,1592,796,796,0,596,3.883,0.0,0.0,0.0
142,364627301,3,1.525,6.0,1.081,1590,795,795,0,591,0.856,0.22,0.444,0.0
143,365969701,1,1.568,3.0,0.868,1582,791,791,0,592,1.868,0.0,0.504,0.0
144,368897601,18,1.898,6.0,1.227,531,272,259,13,189,1.604,0.0,2.362,0.0
145,370070501,17,1.816,5.0,0.983,1542,777,765,12,571,1.27,0.0,1.612,0.0
146,373885001,8,1.71,5.0,0.938,649,327,322,5,240,1.312,0.0,1.987,0.0
147,376055601,16,2.536,6.0,1.406,215,112,103,9,70,2.955,0.0,1.392,0.0
148,378981801,17,2.067,6.0,1.429,367,189,178,11,126,1.879,0.0,1.435,0.0
149,380010101,9,2.52,6.0,1.394,64,35,29,6,20,3.305,0.0,0.668,0.0
150,380172301,1,1.551,3.0,1.226,1562,781,781,0,590,1.145,0.01,0.0,1.0
151,385043601,16,1.243,5.0,0.734,1515,763,752,11,564,0.965,0.0,1.264,0.0
152,386517601,14,1.644,6.0,1.045,1426,719,707,12,529,1.186,0.0,1.529,0.0
154,389872601,8,1.678,5.0,0.823,1562,784,778,6,591,1.013,0.0,1.625,0.0
155,395191801,1,3.054,4.0,1.2,1310,655,655,0,493,4.233,0.0,0.202,0.0
156,395575601,5,2.171,6.0,1.435,1153,578,575,3,418,1.419,0.0,1.352,0.0
157,398396501,5,1.626,6.0,1.219,1581,792,789,3,592,1.236,0.0,0.549,0.0
159,398553001,1,2.208,2.0,1.052,1586,793,793,0,595,1.999,0.0,0.0,0.0
161,400578401,1,2.106,4.0,1.011,826,413,413,0,309,2.881,0.0,0.0,0.0
162,401584801,1,0.966,1.0,0.708,1612,806,806,0,595,0.049,0.0,0.0,0.0
163,401846601,1,2.09,4.0,1.066,828,414,414,0,312,2.875,0.0,0.504,0.0
164,402248101,1,1.392,3.0,0.91,1578,789,789,0,595,0.64,0.0,0.0,0.0
166,406566101,1,1.787,4.0,0.736,1594,797,797,0,593,2.089,0.0,0.253,0.0
167,406603701,12,1.498,6.0,0.911,1604,806,798,8,596,0.91,0.0,1.54,0.0
168,408721401,14,1.594,6.0,0.917,997,503,494,9,375,1.45,0.0,0.925,0.07
169,408855301,12,1.652,6.0,0.825,1193,600,593,7,441,0.974,0.0,1.734,0.0
170,409305601,1,1.92,2.0,1.002,886,443,443,0,334,1.989,0.0,0.0,0.0
171,409319701,1,1.421,5.0,0.88,1592,796,796,0,592,1.058,0.0,0.145,0.0
172,409470301,1,1.372,3.0,0.901,1582,791,791,0,590,0.634,0.0,0.045,0.0
173,410577001,1,2.819,4.0,1.427,1618,809,809,0,595,3.877,0.0,0.0,0.0
174,410979301,2,1.88,6.0,0.898,1416,708,708,0,532,1.285,0.0,0.055,0.5
175,411238201,1,1.78,3.0,1.041,1460,730,730,0,539,1.186,0.02,0.0,0.0
176,412116801,12,2.074,6.0,1.195,425,216,209,7,152,2.103,0.01,2.582,0.08
177,412341901,1,1.451,3.0,1.092,803,402,401,1,300,0.835,0.0,0.0,0.0
179,416619601,13,1.796,6.0,0.93,606,305,301,4,221,1.758,0.0,1.729,0.15
180,416927301,8,1.985,6.0,1.351,345,176,169,7,121,1.074,0.01,0.916,0.0
181,417545801,7,1.371,6.0,1.045,1621,811,810,1,594,1.011,0.0,1.705,0.0
182,417865101,20,2.548,6.0,1.341,238,127,111,16,82,2.636,0.0,1.516,0.0
183,418308401,3,1.417,6.0,0.988,1510,755,755,0,560,0.943,0.0,2.546,0.0
184,418401701,3,1.417,2.0,0.671,1578,790,788,2,594,1.246,0.0,0.157,0.0
185,419089101,16,1.847,5.0,0.804,863,437,426,11,319,1.458,0.0,1.792,0.0
186,421152101,12,1.518,6.0,1.087,963,485,478,7,359,1.218,0.0,1.457,0.0
187,423938701,9,1.524,5.0,1.304,1145,576,569,7,424,0.854,0.0,1.347,0.0
188,424387101,9,1.281,5.0,0.835,460,232,228,4,166,1.565,0.0,0.677,0.0
189,428923101,1,2.744,4.0,1.106,320,160,160,0,121,3.871,0.0,0.0,0.0
190,430884601,9,1.388,6.0,1.127,1618,812,806,6,593,0.816,0.0,0.961,0.0
192,431390701,8,1.382,6.0,0.941,448,226,222,4,167,1.293,0.0,0.965,0.0
193,431815001,3,1.764,6.0,1.017,1560,780,780,0,590,1.263,0.0,0.616,0.0
195,433299001,1,2.3,3.0,1.505,358,179,179,0,130,2.203,0.0,0.169,0.0
197,435199201,1,3.277,4.0,0.782,1052,526,526,0,396,4.774,0.0,1.256,0.0
198,435713701,14,1.648,6.0,1.243,1598,803,795,8,593,0.989,0.0,2.389,0.0
199,436351801,3,1.469,5.0,0.679,1590,795,795,0,594,1.462,0.0,0.986,0.0
