,client_id,reconnections,lat_mean,lat_max,lat_min,total_msgs,out_msgs,in_msgs,lost_msgs,active_time,rtt_rmse,opt_rate,discovery_rmse,discovery_rate
0,177830201,313,4.817,6.0,1.073,1290,766,524,242,337,7.007,0.0,1.953,0.01
2,178483501,52,4.535,5.0,0.799,181,113,68,45,44,6.764,0.0,2.074,0.02
3,178885001,473,4.441,6.0,1.005,2199,1258,941,317,590,6.725,0.0,1.963,0.01
4,181758601,44,2.508,6.0,1.042,581,307,274,33,199,2.448,0.0,1.617,0.0
5,182232701,1,3.832,4.0,1.352,1572,786,786,0,591,5.473,0.0,0.378,0.0
7,183533601,259,4.843,6.0,1.126,949,582,367,215,242,6.533,0.0,1.95,0.0
8,184507401,1,2.224,3.0,1.703,658,329,329,0,247,2.006,0.0,0.253,0.0
9,185892901,183,3.647,6.0,1.451,1204,668,536,132,364,2.938,0.0,1.907,0.0
10,186028501,1,1.464,2.0,1.079,1592,796,796,0,592,0.117,0.0,0.0,0.0
11,186821501,1,3.986,5.0,1.735,723,362,361,1,267,5.586,0.0,0.378,0.0
12,187319101,1,1.883,2.0,1.102,106,53,53,0,38,1.982,0.0,0.253,0.0
13,187426001,226,5.943,7.0,2.046,738,456,282,174,170,6.762,0.04,2.142,0.01
14,187758401,5,1.352,6.0,0.929,1618,809,809,0,594,0.958,0.0,0.683,0.0
15,187781201,319,4.482,6.0,0.931,1628,927,701,226,462,6.319,0.0,1.983,0.01
16,189660101,200,4.694,6.0,1.028,922,538,384,154,256,7.253,0.0,2.095,0.0
17,189877301,192,4.79,6.0,0.675,738,441,297,144,190,7.018,0.01,2.172,0.01
18,192487201,172,3.634,6.0,0.952,1055,601,454,147,326,3.336,0.0,2.132,0.01
19,195978501,1,1.909,4.0,1.231,689,345,344,1,254,1.585,0.0,0.0,0.0
20,196727701,379,4.844,6.0,0.83,1322,812,510,302,323,6.646,0.0,2.126,0.0
21,199485101,125,4.617,6.0,0.766,454,277,177,100,110,6.799,0.0,2.22,0.0
22,199836701,118,4.572,6.0,0.714,747,416,331,85,226,7.244,0.0,1.891,0.01
23,200512301,226,3.344,6.0,1.119,1673,930,743,187,531,2.945,0.0,1.947,0.0
24,202213001,355,4.446,6.0,0.966,1763,1004,759,245,486,6.727,0.0,1.766,0.01
25,202911501,1,1.045,2.0,0.9,634,317,317,0,236,0.34,0.0,0.0,0.0
26,204654801,54,4.119,6.0,1.47,1648,844,804,40,592,5.601,0.0,1.901,0.02
27,205014901,1,2.168,2.0,1.221,1004,502,502,0,372,1.76,0.0,0.0,1.0
28,206569901,1,1.442,2.0,1.077,510,255,255,0,193,0.909,0.0,0.253,0.0
29,207082401,66,1.801,6.0,0.819,1463,760,703,57,527,1.117,0.26,2.18,0.0
30,208812001,1,3.242,4.0,0.887,354,177,177,0,133,5.211,0.0,0.0,0.0
31,210350901,117,4.644,5.0,0.873,429,260,169,91,107,7.178,0.02,2.317,0.02
32,210919601,290,6.078,7.0,2.12,989,591,398,193,225,6.808,0.0,2.116,0.0
33,212667701,57,3.634,6.0,1.315,1647,842,805,37,593,4.821,0.0,2.086,0.0
34,212769701,168,5.121,6.0,1.51,557,351,206,145,140,7.395,0.0,2.28,0.0
35,214367601,94,4.671,6.0,1.006,419,249,170,79,119,7.118,0.0,2.348,0.0
36,217649401,344,4.115,6.0,0.96,2026,1132,894,238,590,6.054,0.0,1.934,0.02
37,217764201,449,4.527,6.0,0.941,1941,1128,813,315,509,6.484,0.0,1.907,0.02
38,218303001,478,4.55,6.0,1.02,2235,1277,958,319,594,6.789,0.0,1.835,0.02
39,218688101,1,1.931,2.0,1.019,1316,658,658,0,482,1.759,0.0,0.0,0.0
40,219468301,1,2.288,4.0,0.991,1454,727,727,0,544,2.004,0.0,0.0,0.0
41,219511701,126,4.326,6.0,1.321,1604,833,771,62,530,7.045,0.0,1.726,0.0
42,219900501,437,4.571,6.0,0.925,1673,1001,672,329,426,6.684,0.0,1.866,0.01
43,220699801,1,1.385,2.0,1.056,640,320,320,0,236,1.181,0.0,0.0,0.0
44,220961301,25,4.505,6.0,1.492,100,60,40,20,24,5.193,0.0,2.008,0.04
45,222570001,319,4.771,6.0,1.171,1137,702,435,267,293,6.413,0.0,1.991,0.02
46,222993101,545,4.697,6.0,1.208,2282,1327,955,372,595,6.685,0.0,1.944,0.01
47,223048501,229,4.367,6.0,0.702,939,562,377,185,249,6.324,0.0,2.124,0.0
48,223120401,1,1.299,2.0,0.89,1574,787,787,0,591,0.103,0.0,0.018,0.0
49,223856401,371,4.997,6.0,0.983,1421,845,576,269,350,7.247,0.0,2.13,0.0
50,224397101,324,4.655,6.0,0.871,1323,788,535,253,352,6.555,0.0,1.995,0.0
51,226600001,371,4.642,6.0,0.955,1683,970,713,257,451,7.083,0.0,1.902,0.01
52,231526101,80,4.2,6.0,1.762,1682,870,812,58,591,5.688,0.0,2.071,0.0
53,232198601,82,4.179,6.0,0.864,1630,842,788,54,565,6.908,0.0,1.81,0.02
55,235994101,1,1.179,2.0,0.788,509,255,254,1,194,0.353,0.0,0.022,0.0
56,236937001,1,3.895,4.0,2.058,126,63,63,0,47,4.978,0.0,0.504,0.0
57,240029901,191,3.95,6.0,1.09,1813,964,849,115,591,6.394,0.0,1.97,0.01
58,240989701,1,1.907,3.0,1.377,528,264,264,0,203,0.889,0.0,0.0,0.0
59,242921301,1,1.22,1.0,0.82,274,137,137,0,104,0.156,0.01,0.036,0.0
60,245740201,368,4.438,6.0,1.006,2085,1169,916,253,592,6.765,0.0,1.793,0.02
61,247273001,354,5.01,6.0,1.064,1248,758,490,268,305,7.149,0.0,2.091,0.01
62,248044901,270,4.164,6.0,0.871,1941,1063,878,185,591,6.502,0.0,1.846,0.01
63,253529101,1,3.574,4.0,1.066,1596,798,798,0,596,4.734,0.0,0.0,0.0
64,256334601,1,3.789,4.0,1.317,492,246,246,0,181,4.953,0.0,0.0,0.0
65,257051801,1,2.826,3.0,1.604,1614,807,807,0,595,2.968,0.0,0.0,0.0
66,257872901,97,5.859,7.0,2.189,329,197,132,65,75,7.254,0.0,2.314,0.0
67,259827801,523,4.753,6.0,0.973,2086,1224,862,362,519,6.735,0.03,1.941,0.01
68,261217901,80,6.238,7.0,2.562,268,167,101,66,66,5.094,0.0,1.874,0.0
69,262938201,38,4.772,6.0,1.044,191,111,80,31,55,7.055,0.0,2.184,0.0
70,263181301,1,1.122,2.0,0.825,308,154,154,0,115,0.031,0.0,0.0,0.0
71,266876301,1,1.161,2.0,0.925,908,454,454,0,338,0.127,0.0,0.0,0.0
72,267044101,467,4.437,6.0,1.197,2134,1249,885,364,591,5.205,0.0,1.912,0.0
73,267411001,169,4.615,6.0,1.127,875,498,377,121,245,7.229,0.0,2.165,0.0
74,268164901,332,4.557,6.0,0.913,1417,826,591,235,366,7.051,0.0,1.869,0.0
75,268192501,1,3.677,4.0,0.856,1582,791,791,0,595,5.462,0.0,0.0,0.0
76,269306201,411,4.619,6.0,0.681,1617,962,655,307,421,6.366,0.0,1.898,0.0
77,270552801,1,1.234,2.0,0.688,1279,640,639,1,484,0.843,0.28,0.0,0.0
78,270862901,1,1.945,2.0,1.308,504,252,252,0,191,1.519,0.0,0.0,1.0
79,271207601,1,1.948,2.0,1.311,238,119,119,0,87,1.994,0.0,0.0,0.0
80,271501201,1,3.067,4.0,1.775,1202,601,601,0,449,1.801,0.0,0.0,0.0
81,271671501,144,3.893,6.0,1.185,1249,676,573,103,404,4.885,0.0,2.065,0.01
82,273687001,1,1.685,2.0,1.584,14,7,7,0,5,0.217,0.0,0.0,0.0
83,274252701,440,4.341,6.0,1.11,2193,1238,955,283,595,6.027,0.0,1.88,0.01
84,275473701,1,1.336,2.0,1.011,232,116,116,0,88,0.181,0.03,0.0,0.0
85,282893001,4,1.35,6.0,1.194,1579,791,788,3,590,0.121,0.0,1.462,0.25
86,283237601,140,4.846,7.0,1.052,616,356,260,96,158,6.463,0.0,2.119,0.01
87,284492401,316,4.36,6.0,0.963,2043,1118,925,193,592,6.666,0.0,2.048,0.01
88,285373201,323,4.416,6.0,0.922,1339,794,545,249,353,5.986,0.01,2.006,0.01
89,285391201,1,2.076,2.0,0.994,192,96,96,0,71,1.991,0.0,0.0,0.0
90,287074901,383,4.454,6.0,0.927,2026,1169,857,312,593,6.606,0.0,2.08,0.0
91,287392801,1,2.673,3.0,1.189,1594,797,797,0,596,2.96,0.0,0.0,0.0
92,287882201,132,3.974,6.0,0.991,1554,827,727,100,524,5.21,0.0,2.141,0.01
94,291918801,1,1.129,2.0,0.75,1216,608,608,0,456,0.116,0.0,0.0,0.0
95,294077501,1,2.963,4.0,1.604,1038,519,519,0,391,2.983,0.0,0.169,0.0
96,294851801,526,4.389,6.0,1.066,2293,1321,972,349,594,6.002,0.0,1.957,0.02
97,295786301,209,3.876,6.0,1.34,1171,657,514,143,336,4.075,0.0,1.717,0.0
98,295832401,242,4.861,6.0,1.009,892,533,359,174,220,7.437,0.0,2.089,0.0
99,296967301,1,1.994,3.0,0.908,1582,791,791,0,592,1.93,0.0,0.253,0.0
100,297260101,165,4.408,6.0,1.103,766,443,323,120,208,7.018,0.0,2.099,0.0
101,298719001,17,2.152,6.0,0.96,483,247,236,11,175,2.234,0.0,2.136,0.0
102,303018401,276,4.317,6.0,0.874,1978,1064,914,150,591,6.879,0.0,1.815,0.02
103,303502201,538,4.782,6.0,1.372,2313,1317,996,321,583,6.791,0.0,1.909,0.01
104,305705001,328,3.709,6.0,0.972,1983,1113,870,243,591,4.01,0.01,1.948,0.02
105,311266501,28,1.787,5.0,0.746,1621,819,802,17,593,2.871,0.0,2.252,0.04
106,312987901,1,1.003,1.0,0.861,1586,793,793,0,595,0.014,0.0,0.0,0.0
107,313099201,483,4.64,6.0,0.994,1898,1104,794,310,468,7.08,0.01,1.931,0.01
108,313599001,143,2.76,5.0,0.778,1035,576,459,117,320,2.928,0.0,2.141,0.01
109,314610001,327,4.964,6.0,0.972,1186,725,461,264,295,6.971,0.0,1.956,0.01
110,316062301,1,1.172,2.0,0.82,1230,615,615,0,463,0.322,0.0,0.022,0.0
111,317049401,1,2.964,3.0,1.496,458,229,229,0,170,3.002,0.0,0.169,0.0
112,319360201,121,5.29,6.0,1.495,394,248,146,102,97,7.072,0.0,1.962,0.0
113,321259701,203,5.769,7.0,2.612,831,485,346,139,212,4.804,0.01,1.948,0.01
114,323653801,3,1.185,5.0,0.745,1596,798,798,0,591,0.475,0.0,0.556,0.0
115,323793801,310,5.015,6.0,1.277,1116,671,445,226,271,7.203,0.0,2.061,0.0
116,324962901,447,4.777,6.0,1.072,1724,1008,716,292,427,7.214,0.0,1.939,0.01
117,325995301,1,1.17,1.0,0.935,1598,799,799,0,590,0.105,0.0,0.036,0.0
118,328599801,1,3.353,4.0,1.138,1580,790,790,0,595,4.741,0.0,0.101,0.0
119,328792801,445,4.319,6.0,0.887,2159,1241,918,323,596,5.964,0.0,1.944,0.01
120,331554501,1,1.616,3.0,0.924,704,352,352,0,262,1.557,0.0,0.0,0.0
121,332552101,1,1.765,3.0,1.304,996,498,498,0,377,0.757,0.0,0.036,0.0
122,333665401,571,5.003,7.0,1.158,2322,1353,969,384,591,6.497,0.0,1.877,0.01
123,334480801,267,4.069,6.0,1.179,1390,784,606,178,384,4.394,0.0,1.902,0.0
124,340860901,302,4.598,6.0,1.101,1636,910,726,184,458,6.852,0.0,1.898,0.01
125,340955901,3,1.567,5.0,0.953,940,470,470,0,348,1.097,0.0,0.15,0.0
126,341378901,1,1.355,2.0,0.79,846,423,423,0,318,0.771,0.0,0.078,0.0
127,342463701,1,3.649,5.0,1.591,1204,602,602,0,458,4.998,0.0,0.504,0.0
128,342552501,185,4.689,6.0,1.14,811,483,328,155,223,7.187,0.0,2.122,0.0
129,344386601,80,2.978,6.0,0.828,822,438,384,54,266,4.289,0.0,1.516,0.0
130,345126301,1,1.335,4.0,0.865,320,160,160,0,122,1.259,0.0,0.078,0.0
131,345397901,269,4.416,6.0,0.82,1217,718,499,219,340,5.925,0.0,2.006,0.0
132,346006301,1,1.619,4.0,1.172,1090,545,545,0,402,1.261,0.0,0.0,0.0
133,347058701,3,1.288,6.0,0.865,1574,787,787,0,592,0.56,0.0,0.144,0.0
134,348560401,1,1.774,3.0,0.925,1604,802,802,0,596,1.551,0.0,0.0,0.0
135,348606901,3,1.283,5.0,0.919,1582,791,791,0,590,0.825,0.0,0.15,0.0
136,351329101,204,3.964,6.0,1.163,1808,990,818,172,596,4.864,0.0,2.24,0.0
137,353021501,143,4.674,6.0,1.322,610,364,246,118,161,6.389,0.0,2.437,0.0
139,356373201,1,1.452,2.0,1.01,1390,695,695,0,525,0.315,0.0,0.0,0.0
140,358732701,554,4.657,6.0,1.117,2277,1339,938,401,590,6.606,0.0,1.847,0.01
141,360465001,3,1.333,5.0,0.722,1596,798,798,0,596,0.788,0.0,0.083,0.0
142,364627301,547,4.697,6.0,1.118,2295,1339,956,383,591,6.663,0.01,1.899,0.01
143,365969701,313,4.023,6.0,0.894,1969,1103,866,237,592,5.94,0.0,1.957,0.01
144,368897601,1,1.632,5.0,1.227,509,255,254,1,189,1.089,0.0,0.184,0.0
145,370070501,382,4.397,6.0,1.109,2033,1142,891,251,571,5.946,0.0,1.772,0.02
146,373885001,1,1.204,2.0,0.951,640,320,320,0,240,0.156,0.01,0.0,0.0
147,376055601,80,5.003,6.0,1.418,304,176,128,48,70,7.45,0.0,2.232,0.0
148,378981801,1,3.734,4.0,1.429,345,173,172,1,126,4.94,0.0,0.0,0.0
149,380010101,13,3.87,6.0,1.534,71,39,32,7,20,4.926,0.0,1.9,0.0
150,380172301,1,1.191,2.0,0.908,1562,781,781,0,590,0.308,0.0,0.072,0.0
151,385043601,46,3.252,6.0,0.759,1555,793,762,31,564,4.965,0.0,1.396,0.0
152,386517601,388,4.532,6.0,1.045,1883,1093,790,303,529,6.397,0.0,1.966,0.01
154,389872601,330,3.955,6.0,0.891,1949,1106,843,263,591,4.71,0.0,2.075,0.0
155,395191801,481,4.572,6.0,1.039,1916,1135,781,354,493,6.146,0.01,1.928,0.02
156,395575601,353,4.412,6.0,1.344,1601,926,675,251,418,4.838,0.0,2.005,0.01
157,398396501,245,3.258,6.0,1.018,1902,1032,870,162,592,3.775,0.0,1.791,0.0
159,398553001,1,1.482,2.0,1.052,1586,793,793,0,595,0.626,0.0,0.0,0.0
161,400578401,337,4.65,6.0,0.903,1229,749,480,269,309,6.755,0.0,2.015,0.01
162,401584801,318,3.111,6.0,0.708,2005,1123,882,241,595,3.611,0.0,1.987,0.01
163,401846601,3,1.437,5.0,1.166,832,416,416,0,312,1.116,0.0,0.195,0.0
164,402248101,331,4.118,6.0,0.937,2026,1119,907,212,595,6.06,0.03,1.91,0.03
166,406566101,529,4.621,6.0,0.911,2271,1325,946,379,593,6.447,0.0,1.917,0.02
167,406603701,415,4.333,6.0,1.093,2123,1209,914,295,596,5.945,0.0,1.943,0.01
168,408721401,1,1.041,2.0,0.664,980,490,490,0,375,0.023,0.0,0.0,1.0
169,408855301,368,4.735,6.0,0.895,1640,956,684,272,441,6.522,0.0,2.007,0.01
170,409305601,1,1.918,2.0,1.002,886,443,443,0,334,2.001,0.0,0.0,0.0
171,409319701,395,4.092,6.0,0.864,2075,1190,885,305,592,4.717,0.0,2.039,0.01
172,409470301,3,1.399,5.0,0.945,1586,793,793,0,590,0.862,0.0,0.286,0.0
173,410577001,3,1.449,5.0,1.148,1622,811,811,0,595,0.499,0.0,0.08,0.0
174,410979301,3,1.607,3.0,0.862,1416,709,707,2,532,0.667,0.0,0.234,0.0
175,411238201,1,1.537,2.0,1.225,1460,730,730,0,539,0.654,0.0,0.184,0.0
176,412116801,1,1.521,3.0,1.132,410,205,205,0,152,0.948,0.0,0.036,0.0
177,412341901,336,4.662,6.0,0.868,1196,737,459,278,300,6.597,0.0,2.013,0.01
179,416619601,229,4.912,6.0,0.93,840,521,319,202,221,6.889,0.0,2.125,0.0
180,416927301,1,2.396,4.0,1.452,338,169,169,0,121,2.017,0.0,0.101,0.0
181,417545801,384,4.177,6.0,0.965,2136,1188,948,240,594,6.246,0.0,1.87,0.01
182,417865101,95,5.168,6.0,1.373,324,202,122,80,82,6.938,0.0,2.212,0.0
183,418308401,357,4.299,6.0,1.038,1956,1109,847,262,560,6.312,0.01,1.952,0.03
184,418401701,3,1.28,5.0,0.671,1580,790,790,0,594,1.128,0.0,0.524,0.0
185,419089101,306,4.823,6.0,0.886,1217,727,490,237,319,6.787,0.01,1.993,0.01
186,421152101,1,1.136,2.0,0.885,948,474,474,0,359,0.14,0.01,0.0,0.0
187,423938701,285,3.894,6.0,1.069,1489,852,637,215,424,4.41,0.0,2.063,0.01
188,424387101,3,4.024,5.0,0.899,452,226,226,0,166,6.873,0.0,0.993,0.0
189,428923101,1,3.294,4.0,1.104,320,160,160,0,121,5.107,0.0,0.0,0.0
190,430884601,160,4.102,6.0,1.182,1822,963,859,104,593,5.824,0.0,2.127,0.01
192,431390701,176,4.742,6.0,1.088,671,394,277,117,167,7.46,0.0,2.066,0.01
193,431815001,476,4.347,6.0,0.943,2164,1253,911,342,590,5.566,0.0,1.96,0.01
195,433299001,148,4.958,6.0,1.321,552,326,226,100,130,7.222,0.0,2.189,0.0
197,435199201,323,4.645,6.0,0.956,1464,848,616,232,396,7.054,0.0,1.96,0.0
198,435713701,246,3.547,6.0,1.284,1870,1035,835,200,593,2.943,0.0,2.109,0.02
199,436351801,1,1.977,2.0,0.679,1586,793,793,0,594,1.928,0.0,0.0,0.0
