,client_id,reconnections,lat_mean,lat_max,lat_min,total_msgs,out_msgs,in_msgs,lost_msgs,active_time,rtt_rmse,opt_rate,discovery_rmse,discovery_rate
0,177830201,348,4.461,6.0,0.841,1323,801,522,279,337,5.573,0.05,0.014,0.98
2,178483501,51,3.916,5.0,0.783,176,112,64,48,44,4.535,0.0,0.0,1.0
3,178885001,244,2.734,6.0,0.932,1857,1029,828,201,590,2.583,0.02,0.017,0.98
4,181758601,217,4.532,6.0,0.815,770,480,290,190,199,5.883,0.01,0.006,0.98
5,182232701,346,3.496,6.0,0.973,2007,1131,876,255,591,3.926,0.02,0.007,0.98
7,183533601,275,4.756,6.0,0.982,948,598,350,248,242,5.504,0.03,0.004,0.99
8,184507401,259,4.583,6.0,0.761,952,587,365,222,247,5.6,0.07,0.011,0.99
9,185892901,327,4.367,6.0,1.418,1368,812,556,256,364,3.267,0.03,0.004,0.99
10,186028501,19,1.646,6.0,1.079,1610,814,796,18,592,0.322,0.0,0.0,1.0
11,186821501,110,3.339,6.0,0.699,836,471,365,106,267,2.298,0.0,0.0,1.0
12,187319101,42,4.137,6.0,0.849,152,94,58,36,38,6.289,0.06,0.0,1.0
13,187426001,217,5.584,7.0,2.02,719,447,272,175,170,4.991,0.0,0.003,0.99
14,187758401,332,3.28,6.0,0.761,2022,1136,886,250,594,3.887,0.02,0.004,0.95
15,187781201,20,1.675,6.0,1.066,1239,628,611,17,462,1.073,0.0,0.0,1.0
16,189660101,279,4.433,6.0,0.78,987,617,370,247,256,5.604,0.01,0.005,0.99
17,189877301,205,4.476,6.0,0.675,724,454,270,184,190,5.583,0.02,0.003,1.0
18,192487201,355,4.628,6.0,0.769,1255,784,471,313,326,5.368,0.06,0.0,1.0
19,195978501,273,4.378,6.0,0.861,1004,617,387,230,254,5.367,0.03,0.005,0.99
20,196727701,247,3.801,6.0,0.729,1139,680,459,221,323,3.211,0.01,0.016,0.99
21,199485101,133,4.468,6.0,0.761,450,285,165,120,110,5.936,0.06,0.0,1.0
22,199836701,70,2.516,6.0,0.714,680,368,312,56,226,2.744,0.0,0.008,0.96
23,200512301,293,3.377,6.0,0.769,1737,997,740,257,531,2.899,0.0,0.003,0.99
24,202213001,233,2.877,6.0,0.746,1557,882,675,207,486,2.113,0.01,0.0,1.0
25,202911501,134,2.894,6.0,0.735,781,450,331,119,236,2.648,0.01,0.003,0.99
26,204654801,391,3.717,6.0,0.867,2062,1181,881,300,592,3.154,0.02,0.003,0.99
27,205014901,367,4.622,6.0,1.221,1418,868,550,318,372,4.872,0.02,0.002,1.0
28,206569901,208,4.326,6.0,0.824,735,462,273,189,193,5.197,0.05,0.0,1.0
29,207082401,346,3.717,6.0,0.934,1782,1040,742,298,527,3.23,0.01,0.011,0.99
30,208812001,157,4.35,5.0,0.722,521,333,188,145,133,5.655,0.06,0.007,0.98
31,210350901,122,4.238,5.0,0.851,416,265,151,114,107,5.235,0.03,0.0,1.0
32,210919601,57,3.573,7.0,2.321,674,358,316,42,225,1.412,0.01,0.0,1.0
33,212667701,371,3.534,6.0,0.718,2000,1156,844,312,593,3.261,0.04,0.0,1.0
34,212769701,158,4.572,6.0,0.765,536,341,195,146,140,5.355,0.03,0.005,0.99
35,214367601,136,4.376,6.0,0.734,454,291,163,128,119,5.628,0.0,0.0,1.0
36,217649401,335,3.228,6.0,0.712,1968,1123,845,278,590,3.299,0.02,0.003,1.0
37,217764201,371,3.756,6.0,0.783,1779,1050,729,321,509,3.606,0.02,0.002,1.0
38,218303001,203,2.517,6.0,0.975,1824,1002,822,180,594,1.838,0.01,0.003,0.99
39,218688101,19,1.662,6.0,1.144,1338,676,662,14,482,1.126,0.0,0.011,0.95
40,219468301,111,2.236,6.0,0.884,1572,837,735,102,544,1.229,0.0,0.0,1.0
41,219511701,195,2.553,5.0,0.747,1630,902,728,174,530,2.425,0.14,0.0,1.0
42,219900501,20,1.387,6.0,0.976,1153,584,569,15,426,0.82,0.01,0.0,1.0
43,220699801,80,2.618,6.0,0.82,729,399,330,69,236,3.468,0.02,0.0,1.0
44,220961301,30,4.669,6.0,1.324,104,65,39,26,24,6.072,0.0,0.0,1.0
45,222570001,242,4.056,6.0,1.077,1031,625,406,219,293,3.5,0.02,0.0,1.0
46,222993101,337,3.45,6.0,1.097,1946,1119,827,292,595,2.864,0.0,0.005,0.98
47,223048501,282,4.482,6.0,0.785,977,615,362,253,249,5.812,0.03,0.0,1.0
48,223120401,370,3.504,6.0,0.873,2017,1156,861,295,591,2.947,0.02,0.002,1.0
49,223856401,319,4.206,6.0,0.925,1341,793,548,245,350,4.894,0.03,0.005,0.98
50,224397101,112,2.572,6.0,0.846,1045,576,469,107,352,1.241,0.0,0.0,1.0
51,226600001,361,3.916,6.0,0.84,1622,960,662,298,451,4.383,0.02,0.003,0.99
52,231526101,199,2.741,6.0,1.154,1799,989,810,179,591,1.64,0.0,0.009,0.98
53,232198601,42,1.324,5.0,0.787,1565,802,763,39,565,0.739,0.0,0.0,1.0
55,235994101,200,4.35,6.0,0.765,724,454,270,184,194,4.756,0.06,0.0,1.0
56,236937001,57,4.756,6.0,1.535,183,119,64,55,47,1.354,0.0,0.005,0.98
57,240029901,219,2.536,5.0,0.789,1793,992,801,191,591,2.429,0.01,0.004,1.0
58,240989701,224,4.781,6.0,1.377,781,487,294,193,203,5.151,0.07,0.003,0.99
59,242921301,121,4.857,6.0,1.026,403,257,146,111,104,6.112,0.0,0.0,1.0
60,245740201,65,1.74,5.0,0.951,1672,866,806,60,592,0.963,0.01,0.0,1.0
61,247273001,343,4.771,6.0,1.122,1194,747,447,300,305,5.587,0.03,0.007,0.99
62,248044901,107,2.154,5.0,0.881,1702,900,802,98,591,1.633,0.0,0.0,1.0
63,253529101,21,1.732,6.0,1.066,1620,818,802,16,596,1.047,0.0,0.0,1.0
64,256334601,214,4.824,6.0,1.225,726,459,267,192,181,5.65,0.04,0.002,1.0
65,257051801,1,2.304,4.0,1.355,1614,807,807,0,595,2.706,0.0,0.0,1.0
66,257872901,99,5.512,7.0,1.978,321,199,122,77,75,6.201,0.13,0.005,0.93
67,259827801,53,1.901,6.0,1.046,1458,754,704,50,519,0.721,0.0,0.006,0.98
68,261217901,86,6.281,7.0,2.36,266,173,93,80,66,2.331,0.0,0.0,1.0
69,262938201,64,4.474,6.0,0.791,213,137,76,61,55,4.441,0.0,0.0,1.0
70,263181301,129,4.476,6.0,0.946,452,282,170,112,115,6.003,0.07,0.0,1.0
71,266876301,342,4.291,6.0,0.869,1303,795,508,287,338,5.075,0.04,0.004,0.99
72,267044101,371,3.613,6.0,1.149,1988,1153,835,318,591,3.073,0.02,0.003,0.99
73,267411001,267,4.431,6.0,0.82,954,596,358,238,245,5.529,0.05,0.007,0.99
74,268164901,348,4.12,6.0,0.689,1408,842,566,276,366,5.343,0.06,0.006,0.98
75,268192501,21,1.328,5.0,0.763,1604,811,793,18,595,0.606,0.0,0.013,0.9
76,269306201,295,3.797,6.0,0.917,1437,846,591,255,421,3.099,0.02,0.003,0.99
77,270552801,292,3.282,6.0,0.771,1594,931,663,268,484,2.544,0.01,0.003,0.99
78,270862901,202,4.696,6.0,1.055,742,453,289,164,191,6.056,0.03,0.0,1.0
79,271207601,20,1.888,6.0,0.791,259,138,121,17,87,1.489,0.0,0.0,1.0
80,271501201,406,4.979,7.0,1.775,1699,1006,693,313,449,3.215,0.02,0.008,1.0
81,271671501,41,1.835,6.0,0.88,1113,573,540,33,404,1.03,0.0,0.0,1.0
82,273687001,5,4.109,6.0,1.584,19,11,8,3,5,6.544,0.33,0.0,1.0
83,274252701,274,3.08,6.0,0.827,1923,1072,851,221,595,2.873,0.01,0.002,1.0
84,275473701,37,3.086,6.0,1.011,270,152,118,34,88,1.752,0.01,0.0,1.0
85,282893001,345,3.522,6.0,1.125,1992,1132,860,272,590,3.491,0.02,0.004,0.99
86,283237601,1,3.884,5.0,1.052,434,217,217,0,158,4.999,0.0,0.0,1.0
87,284492401,273,2.96,6.0,0.662,1920,1075,845,230,592,2.925,0.02,0.003,0.99
88,285373201,112,2.525,6.0,0.926,1059,583,476,107,353,1.299,0.0,0.0,1.0
89,285391201,84,4.711,6.0,0.994,280,179,101,78,71,5.981,0.0,0.005,0.99
90,287074901,280,2.85,6.0,0.717,1887,1066,821,245,593,2.377,0.01,0.0,1.0
91,287392801,1,2.157,4.0,0.968,1594,797,797,0,596,2.704,0.0,0.0,1.0
92,287882201,365,3.62,6.0,0.846,1820,1060,760,300,524,3.814,0.04,0.003,0.99
94,291918801,38,1.591,6.0,0.814,1258,645,613,32,456,0.82,0.0,0.0,1.0
95,294077501,371,4.54,6.0,0.906,1462,889,573,316,391,3.987,0.02,0.003,0.99
96,294851801,357,3.434,6.0,0.874,2020,1152,868,284,594,3.195,0.02,0.002,1.0
97,295786301,296,4.231,6.0,1.045,1237,744,493,251,336,3.74,0.03,0.0,1.0
98,295832401,21,1.588,5.0,0.729,606,312,294,18,220,0.822,0.0,0.0,1.0
99,296967301,1,1.23,3.0,0.655,1582,791,791,0,592,0.487,0.0,0.0,1.0
100,297260101,81,2.477,5.0,0.694,642,359,283,76,208,1.417,0.0,0.0,1.0
101,298719001,1,1.198,5.0,0.818,462,231,231,0,175,1.099,0.0,0.0,1.0
102,303018401,52,1.577,5.0,0.725,1635,840,795,45,591,1.014,0.0,0.009,0.96
103,303502201,371,3.723,6.0,1.168,1988,1150,838,312,583,3.344,0.02,0.003,0.99
104,305705001,198,2.539,6.0,0.769,1784,983,801,182,591,1.557,0.0,0.0,1.0
105,311266501,21,1.439,6.0,0.84,1616,812,804,8,593,1.513,0.01,0.0,1.0
106,312987901,10,1.305,6.0,1.114,1595,802,793,9,595,0.511,0.0,0.007,0.9
107,313099201,357,3.823,6.0,0.994,1680,978,702,276,468,4.447,0.03,0.005,0.98
108,313599001,114,2.422,5.0,0.771,983,547,436,111,320,1.279,0.0,0.0,1.0
109,314610001,254,4.005,6.0,0.808,1093,652,441,211,295,3.422,0.03,0.002,1.0
110,316062301,302,3.456,6.0,0.796,1553,916,637,279,463,2.721,0.01,0.002,1.0
111,317049401,191,4.802,6.0,1.455,674,419,255,164,170,5.673,0.05,0.005,0.99
112,319360201,115,4.875,6.0,1.228,377,242,135,107,97,4.917,0.0,0.005,0.98
113,321259701,3,2.933,7.0,2.443,569,285,284,1,212,0.517,0.0,0.0,1.0
114,323653801,356,3.348,6.0,0.67,1989,1151,838,313,591,2.779,0.01,0.0,1.0
115,323793801,278,4.651,6.0,1.261,1038,639,399,240,271,5.174,0.03,0.0,1.0
116,324962901,326,3.945,6.0,1.035,1507,887,620,267,427,4.539,0.03,0.001,1.0
117,325995301,18,1.369,5.0,0.97,1615,816,799,17,590,0.264,0.0,0.0,1.0
118,328599801,338,3.266,6.0,0.728,1963,1127,836,291,595,2.891,0.01,0.0,1.0
119,328792801,143,2.241,6.0,0.831,1782,939,843,96,596,2.202,0.01,0.003,0.99
120,331554501,1,2.736,4.0,0.945,704,352,352,0,262,4.052,0.0,0.0,1.0
121,332552101,1,1.415,2.0,0.862,996,498,498,0,377,0.041,0.0,0.0,1.0
122,333665401,410,3.96,7.0,0.99,2060,1192,868,324,591,2.69,0.02,0.003,0.99
123,334480801,354,4.318,6.0,1.138,1478,871,607,264,384,4.97,0.04,0.004,0.98
124,340860901,223,3.074,6.0,0.878,1461,831,630,201,458,2.621,0.01,0.004,0.99
125,340955901,365,4.517,6.0,0.955,1361,832,529,303,348,5.818,0.05,0.0,1.0
126,341378901,109,2.549,5.0,0.712,958,531,427,104,318,1.547,0.0,0.0,1.0
127,342463701,107,2.262,6.0,0.962,1318,708,610,98,458,1.374,0.0,0.004,0.99
128,342552501,18,1.445,6.0,0.789,615,316,299,17,223,0.368,0.0,0.0,1.0
129,344386601,276,4.243,6.0,0.694,1036,634,402,232,266,5.721,0.04,0.002,1.0
130,345126301,135,4.244,5.0,0.762,468,294,174,120,122,6.036,0.08,0.003,0.99
131,345397901,327,4.256,6.0,0.826,1272,776,496,280,340,4.8,0.04,0.005,0.99
132,346006301,270,3.527,6.0,1.07,1377,814,563,251,402,2.488,0.01,0.0,1.0
133,347058701,358,3.409,6.0,1.017,1975,1142,833,309,592,3.012,0.01,0.003,0.99
134,348560401,305,3.173,6.0,0.998,1941,1106,835,271,596,2.247,0.0,0.003,0.99
135,348606901,345,3.241,6.0,0.867,1979,1133,846,287,590,3.185,0.01,0.0,1.0
136,351329101,347,3.364,6.0,1.084,1989,1133,856,277,596,3.451,0.02,0.0,1.0
137,353021501,182,4.416,6.0,0.75,642,403,239,164,161,5.394,0.04,0.0,1.0
139,356373201,162,2.519,6.0,1.004,1571,856,715,141,525,1.742,0.01,0.003,0.99
140,358732701,36,1.934,6.0,1.157,1607,821,786,35,590,1.272,0.01,0.0,1.0
141,360465001,1,1.267,5.0,0.729,1592,796,796,0,596,0.965,0.0,0.0,1.0
142,364627301,331,3.363,6.0,1.045,1974,1123,851,272,591,3.151,0.02,0.003,0.99
143,365969701,20,1.234,5.0,0.795,1601,810,791,19,592,0.391,0.0,0.0,1.0
144,368897601,213,4.692,6.0,0.899,738,467,271,196,189,5.45,0.05,0.017,0.99
145,370070501,360,3.614,6.0,0.983,1930,1120,810,310,571,3.117,0.02,0.0,1.0
146,373885001,266,4.673,6.0,0.952,937,585,352,233,240,5.806,0.01,0.0,1.0
147,376055601,79,4.729,6.0,1.209,291,175,116,59,70,6.644,0.14,0.0,0.92
148,378981801,151,4.853,6.0,1.261,506,323,183,140,126,5.709,0.0,0.0,1.0
149,380010101,5,2.574,6.0,1.51,58,31,27,4,20,1.438,0.05,0.0,0.8
150,380172301,358,3.374,6.0,0.809,1973,1138,835,303,590,3.295,0.01,0.002,1.0
151,385043601,351,3.312,6.0,0.736,1897,1098,799,299,564,3.322,0.02,0.001,1.0
152,386517601,362,3.665,6.0,0.884,1832,1067,765,302,529,3.646,0.0,0.001,1.0
154,389872601,3,1.657,5.0,0.791,1556,779,777,2,591,0.51,0.0,0.0,1.0
155,395191801,280,3.505,6.0,1.098,1610,934,676,258,493,2.498,0.01,0.002,1.0
156,395575601,386,4.305,6.0,1.366,1644,959,685,274,418,4.377,0.04,0.006,0.99
157,398396501,283,2.974,6.0,1.018,1904,1070,834,236,592,2.705,0.01,0.007,0.99
159,398553001,1,2.165,4.0,1.052,1586,793,793,0,595,2.725,0.0,0.0,1.0
161,400578401,239,3.855,6.0,0.822,1078,651,427,224,309,3.043,0.0,0.003,1.0
162,401584801,371,3.312,6.0,0.786,2032,1176,856,320,595,3.099,0.02,0.0,1.0
163,401846601,26,1.538,6.0,0.88,853,439,414,25,312,0.774,0.0,0.0,1.0
164,402248101,35,1.534,6.0,0.874,1616,823,793,30,595,0.861,0.01,0.0,1.0
166,406566101,367,3.537,6.0,0.905,2041,1163,878,285,593,3.485,0.02,0.0,1.0
167,406603701,357,3.493,6.0,0.977,2010,1151,859,292,596,3.404,0.02,0.004,0.99
168,408721401,354,4.28,6.0,0.74,1363,843,520,323,375,4.228,0.04,0.002,0.99
169,408855301,328,3.819,6.0,0.825,1562,916,646,270,441,3.237,0.02,0.006,0.98
170,409305601,234,3.524,5.0,0.796,1145,676,469,207,334,3.51,0.01,0.003,1.0
171,409319701,371,3.395,6.0,0.799,2027,1166,861,305,592,3.407,0.02,0.0,1.0
172,409470301,360,3.398,6.0,0.92,2013,1150,863,287,590,3.549,0.02,0.002,0.99
173,410577001,360,3.511,6.0,1.021,2036,1168,868,300,595,3.35,0.02,0.003,0.99
174,410979301,358,3.877,6.0,0.846,1828,1064,764,300,532,3.59,0.01,0.0,1.0
175,411238201,312,3.378,6.0,0.955,1821,1041,780,261,539,3.029,0.01,0.003,1.0
176,412116801,172,4.532,6.0,0.691,608,376,232,144,152,6.287,0.07,0.004,0.9
177,412341901,334,4.604,6.0,0.844,1189,735,454,281,300,6.283,0.07,0.002,0.99
179,416619601,1,3.235,4.0,0.93,586,293,293,0,221,4.369,0.0,0.0,1.0
180,416927301,151,5.021,6.0,1.351,495,319,176,143,121,5.401,0.04,0.003,0.99
181,417545801,352,3.217,6.0,0.924,2040,1156,884,272,594,3.757,0.03,0.006,0.98
182,417865101,96,5.001,6.0,1.278,315,203,112,91,82,5.352,0.06,0.005,0.99
183,418308401,106,2.012,6.0,0.897,1619,858,761,97,560,1.243,0.0,0.0,1.0
184,418401701,196,2.413,6.0,0.77,1811,983,828,155,594,2.514,0.01,0.0,1.0
185,419089101,294,4.253,6.0,0.752,1183,715,468,247,319,4.203,0.03,0.004,0.99
186,421152101,226,3.508,6.0,0.956,1206,699,507,192,359,3.341,0.01,0.001,1.0
187,423938701,322,3.759,6.0,1.063,1504,889,615,274,424,3.824,0.03,0.005,0.99
188,424387101,191,4.323,5.0,0.834,654,414,240,174,166,5.823,0.06,0.003,0.99
189,428923101,134,4.421,6.0,0.911,472,293,179,114,121,6.586,0.02,0.0,0.96
190,430884601,12,1.477,6.0,1.085,1619,815,804,11,593,0.866,0.0,0.0,1.0
192,431390701,180,4.417,6.0,0.79,639,398,241,157,167,5.848,0.08,0.008,0.96
193,431815001,370,3.506,6.0,0.961,2009,1147,862,285,590,3.278,0.02,0.005,0.99
195,433299001,144,4.599,6.0,1.274,523,322,201,121,130,6.063,0.02,0.003,0.98
197,435199201,206,3.072,6.0,0.68,1270,731,539,192,396,1.966,0.0,0.004,0.99
198,435713701,373,3.595,6.0,1.071,2031,1162,869,293,593,3.336,0.01,0.003,0.99
199,436351801,206,2.419,6.0,0.678,1812,998,814,184,594,1.774,0.0,0.0,1.0
