,client_id,reconnections,lat_mean,lat_max,lat_min,total_msgs,out_msgs,in_msgs,lost_msgs,active_time,rtt_rmse,opt_rate,discovery_rmse,discovery_rate
0,177830201,3,1.465,5.0,1.073,910,456,454,2,337,0.639,0.0,0.892,0.0
2,178483501,3,1.659,5.0,0.801,128,64,64,0,44,2.396,0.02,1.854,0.0
3,178885001,3,1.498,5.0,0.929,1576,788,788,0,590,1.36,0.01,0.412,0.33
4,181758601,1,3.522,4.0,1.198,528,264,264,0,199,4.932,0.0,0.0,0.0
5,182232701,446,4.155,6.0,1.157,2211,1231,980,251,591,5.724,0.0,1.751,0.0
7,183533601,1,1.514,2.0,1.192,647,324,323,1,242,0.563,0.0,0.0,0.0
8,184507401,252,4.704,6.0,1.103,968,580,388,192,247,6.446,0.02,1.769,0.0
9,185892901,156,4.577,6.0,1.483,1153,641,512,129,364,5.13,0.0,1.577,0.04
10,186028501,458,4.385,6.0,1.157,2195,1253,942,311,592,5.162,0.0,1.762,0.0
11,186821501,272,4.826,6.0,1.134,1080,633,447,186,267,6.77,0.0,1.853,0.01
12,187319101,1,1.309,2.0,0.886,106,53,53,0,38,0.841,0.0,0.036,0.0
13,187426001,223,5.753,7.0,2.176,750,453,297,156,170,6.471,0.0,1.728,0.01
14,187758401,3,1.458,6.0,1.017,1614,807,807,0,594,0.998,0.0,0.254,0.0
15,187781201,436,4.627,6.0,0.808,1823,1044,779,265,462,7.095,0.0,1.79,0.01
16,189660101,1,1.348,2.0,0.991,677,339,338,1,256,0.649,0.0,0.0,0.0
17,189877301,172,4.509,6.0,0.675,694,421,273,148,190,6.239,0.0,1.732,0.02
18,192487201,1,4.017,5.0,1.373,860,430,430,0,326,5.865,0.0,0.0,0.0
19,195978501,1,1.306,2.0,0.952,689,345,344,1,254,0.294,0.0,0.113,0.0
20,196727701,335,4.691,6.0,0.945,1308,768,540,228,323,6.818,0.0,1.708,0.01
21,199485101,126,4.677,6.0,0.761,457,278,179,99,110,6.942,0.04,1.913,0.06
22,199836701,145,4.47,6.0,0.714,779,443,336,107,226,7.038,0.01,1.835,0.01
23,200512301,1,1.483,2.0,0.864,1410,705,705,0,531,0.508,0.0,0.046,0.0
24,202213001,205,3.816,6.0,0.748,1617,854,763,91,486,5.994,0.0,1.457,0.0
25,202911501,44,4.045,6.0,1.029,691,360,331,29,236,6.662,0.0,2.395,0.0
26,204654801,1,1.358,2.0,0.735,1582,791,791,0,592,0.069,0.01,0.0,0.0
27,205014901,399,4.884,6.0,1.221,1499,900,599,301,372,6.623,0.0,1.746,0.01
28,206569901,3,1.386,5.0,0.925,514,257,257,0,193,1.062,0.0,0.307,0.0
29,207082401,1,1.276,2.0,0.698,1390,695,695,0,527,0.073,0.01,0.0,0.0
30,208812001,1,1.822,2.0,0.887,354,177,177,0,133,2.003,0.0,0.0,0.0
31,210350901,44,4.43,5.0,0.873,341,187,154,33,107,7.16,0.0,1.569,0.0
32,210919601,1,2.454,3.0,2.069,604,302,302,0,225,0.015,0.0,0.0,0.0
33,212667701,436,4.219,6.0,0.847,2153,1221,932,289,593,5.667,0.0,1.803,0.01
34,212769701,1,3.567,4.0,1.623,368,184,184,0,140,4.895,0.0,0.504,0.0
35,214367601,1,1.111,1.0,0.862,312,156,156,0,119,0.359,0.0,0.0,0.0
36,217649401,241,3.808,6.0,1.006,1927,1029,898,131,590,5.928,0.0,1.638,0.02
37,217764201,1,2.162,3.0,1.143,1360,680,680,0,509,2.009,0.0,0.0,0.0
38,218303001,320,3.922,6.0,1.013,2007,1119,888,231,594,4.953,0.0,1.813,0.02
39,218688101,190,3.128,6.0,0.843,1612,847,765,82,482,4.64,0.0,1.507,0.01
40,219468301,1,3.537,5.0,0.991,1454,727,727,0,544,4.646,0.0,0.0,0.0
41,219511701,28,1.228,5.0,0.698,1449,735,714,21,530,0.998,0.08,1.329,0.04
42,219900501,454,4.685,6.0,0.928,1709,1018,691,327,426,7.102,0.0,1.74,0.01
43,220699801,67,4.01,6.0,1.006,715,386,329,57,236,6.407,0.0,1.872,0.04
44,220961301,23,4.742,6.0,1.37,104,58,46,12,24,6.85,0.0,1.688,0.0
45,222570001,1,1.802,2.0,1.178,768,384,384,0,293,1.51,0.0,0.0,0.0
46,222993101,419,4.509,6.0,1.227,2122,1201,921,280,595,6.051,0.0,1.755,0.0
47,223048501,143,3.575,6.0,0.792,851,476,375,101,249,4.785,0.0,1.655,0.01
48,223120401,2,1.675,5.0,1.057,1576,788,788,0,591,0.97,0.0,0.355,0.0
49,223856401,370,4.766,6.0,0.756,1440,844,596,248,350,6.739,0.0,1.713,0.01
50,224397101,281,4.671,6.0,0.909,1272,745,527,218,352,6.906,0.0,1.649,0.01
51,226600001,1,1.346,2.0,1.009,1200,600,600,0,451,0.549,0.0,0.0,0.0
52,231526101,500,4.451,6.0,1.119,2246,1290,956,334,591,5.776,0.0,1.74,0.01
53,232198601,1,1.114,2.0,0.823,1522,761,761,0,565,0.496,0.0,0.169,0.0
55,235994101,123,4.534,6.0,1.018,649,377,272,105,194,6.676,0.0,1.664,0.01
56,236937001,45,4.908,6.0,1.699,184,107,77,30,47,6.389,0.0,1.936,0.0
57,240029901,22,3.552,6.0,1.089,1580,795,785,10,591,5.747,0.0,1.861,0.0
58,240989701,222,5.077,6.0,1.377,795,485,310,175,203,6.491,0.01,1.782,0.02
59,242921301,69,4.055,6.0,0.968,363,205,158,47,104,5.108,0.0,1.708,0.03
60,245740201,1,3.439,4.0,1.185,1604,802,802,0,592,5.171,0.0,0.202,0.0
61,247273001,1,4.314,5.0,3.008,809,405,404,1,305,6.009,0.0,1.256,0.0
62,248044901,1,1.19,2.0,0.818,1588,794,794,0,591,0.407,0.0,0.253,0.0
63,253529101,1,2.277,2.0,1.066,1596,798,798,0,596,2.009,0.0,0.0,0.0
64,256334601,182,4.622,6.0,1.298,716,427,289,138,181,5.661,0.0,1.651,0.03
65,257051801,393,4.024,6.0,1.161,2160,1199,961,238,595,5.069,0.0,1.696,0.0
66,257872901,1,2.779,4.0,2.231,202,101,101,0,75,1.675,0.0,0.169,0.0
67,259827801,301,4.348,6.0,1.123,1800,1002,798,204,519,5.779,0.0,1.731,0.01
68,261217901,85,6.403,7.0,2.394,276,172,104,68,66,5.89,0.0,1.797,0.0
69,262938201,34,4.327,6.0,0.791,192,107,85,22,55,6.232,0.0,1.545,0.0
70,263181301,22,2.271,6.0,1.185,332,175,157,18,115,1.707,0.0,2.092,0.0
71,266876301,4,1.259,6.0,0.869,914,457,457,0,338,0.938,0.09,0.108,0.5
72,267044101,184,4.172,6.0,1.225,1776,966,810,156,591,5.07,0.0,1.799,0.02
73,267411001,3,3.475,5.0,1.811,662,332,330,2,245,4.962,0.0,0.488,0.0
74,268164901,277,4.515,6.0,1.015,1345,771,574,197,366,6.993,0.0,1.784,0.01
75,268192501,321,3.733,6.0,0.856,2032,1111,921,190,595,4.88,0.0,1.77,0.01
76,269306201,314,4.511,6.0,0.989,1500,865,635,230,421,6.084,0.0,1.701,0.01
77,270552801,205,4.283,6.0,1.013,1574,844,730,114,484,6.85,0.0,1.726,0.0
78,270862901,202,4.778,6.0,1.148,750,453,297,156,191,6.472,0.0,1.707,0.01
79,271207601,1,1.143,1.0,0.844,238,119,119,0,87,0.37,0.0,0.016,0.0
80,271501201,450,5.301,7.0,1.775,1855,1050,805,245,449,5.316,0.0,1.751,0.0
81,271671501,3,1.777,5.0,1.007,1070,535,535,0,404,1.165,0.0,0.334,0.0
82,273687001,1,1.599,2.0,1.584,14,7,7,0,5,0.0,0.0,0.0,0.0
83,274252701,1,2.668,3.0,1.42,1598,799,799,0,595,3.003,0.0,0.0,0.0
84,275473701,89,4.676,6.0,1.142,347,204,143,61,88,6.587,0.02,1.765,0.03
85,282893001,493,4.339,6.0,1.196,2245,1280,965,315,590,5.89,0.0,1.771,0.01
86,283237601,128,4.47,7.0,1.049,583,344,239,105,158,4.476,0.01,1.659,0.04
87,284492401,237,3.941,6.0,0.999,1923,1039,884,155,592,6.001,0.01,1.827,0.01
88,285373201,282,4.527,6.0,0.87,1314,753,561,192,353,6.824,0.0,1.704,0.0
89,285391201,1,1.459,2.0,0.994,192,96,96,0,71,0.763,0.0,0.0,0.0
90,287074901,1,1.133,2.0,0.734,1574,787,787,0,593,0.415,0.0,0.0,0.0
91,287392801,1,2.706,3.0,1.189,1594,797,797,0,596,3.004,0.0,0.0,0.0
92,287882201,3,1.241,6.0,0.724,1396,698,698,0,524,0.546,0.0,0.564,0.0
94,291918801,276,3.811,6.0,0.731,1546,883,663,220,456,4.822,0.0,1.716,0.02
95,294077501,239,4.741,6.0,1.426,1336,757,579,178,391,5.959,0.0,1.805,0.01
96,294851801,1,2.668,3.0,1.535,1592,796,796,0,594,3.008,0.0,0.169,0.0
97,295786301,238,4.114,6.0,1.222,1231,686,545,141,336,5.189,0.0,1.593,0.0
98,295832401,2,1.707,5.0,0.926,586,293,293,0,220,1.363,0.0,0.343,0.0
99,296967301,178,3.666,6.0,1.224,1825,968,857,111,592,5.586,0.0,1.792,0.0
100,297260101,120,4.307,6.0,1.046,707,398,309,89,208,6.69,0.01,1.675,0.01
101,298719001,1,1.147,2.0,0.863,462,231,231,0,175,0.334,0.0,0.0,0.0
102,303018401,1,1.219,2.0,0.862,1578,789,789,0,591,0.484,0.0,0.046,0.0
103,303502201,1,1.598,2.0,1.326,1560,780,780,0,583,0.486,0.0,0.132,0.0
104,305705001,410,3.949,6.0,1.028,2132,1195,937,258,591,4.971,0.0,1.682,0.0
105,311266501,1,1.237,2.0,0.824,1584,792,792,0,593,0.408,0.0,0.078,0.0
106,312987901,1,3.402,4.0,1.168,1586,793,793,0,595,5.179,0.0,0.0,0.0
107,313099201,469,4.589,6.0,1.057,1898,1090,808,282,468,7.024,0.0,1.725,0.01
108,313599001,33,3.108,5.0,0.802,907,466,441,25,320,5.479,0.0,1.57,0.03
109,314610001,1,1.552,2.0,0.977,798,399,399,0,295,0.634,0.0,0.169,0.0
110,316062301,1,1.271,2.0,0.784,1230,615,615,0,463,0.539,0.0,0.133,0.0
111,317049401,1,1.637,2.0,1.566,458,229,229,0,170,0.338,0.0,0.07,0.0
112,319360201,4,1.96,6.0,1.557,261,131,130,1,97,1.588,0.0,0.756,0.0
113,321259701,274,6.237,7.0,2.588,919,556,363,193,212,6.034,0.01,1.792,0.01
114,323653801,399,4.213,6.0,0.705,2155,1194,961,233,591,6.107,0.0,1.835,0.0
115,323793801,1,1.6,2.0,1.345,724,362,362,0,271,0.597,0.0,0.084,0.0
116,324962901,385,4.459,6.0,1.202,1668,946,722,224,427,6.582,0.0,1.68,0.01
117,325995301,490,4.193,6.0,0.938,2241,1288,953,335,590,5.684,0.0,1.68,0.01
118,328599801,1,1.946,2.0,0.919,1580,790,790,0,595,1.875,0.0,0.0,0.0
119,328792801,1,2.137,3.0,0.887,1594,797,797,0,596,2.009,0.0,0.0,0.0
120,331554501,125,4.287,6.0,0.875,851,476,375,101,262,6.889,0.0,1.714,0.0
121,332552101,1,2.418,3.0,1.868,996,498,498,0,377,2.008,0.0,0.253,0.0
122,333665401,1,1.68,3.0,0.979,1566,783,783,0,591,0.418,0.0,0.084,0.0
123,334480801,1,1.678,2.0,1.289,1035,518,517,1,384,0.587,0.0,0.046,0.0
124,340860901,1,2.111,3.0,1.101,1218,609,609,0,458,1.974,0.0,0.0,0.0
125,340955901,378,4.814,6.0,1.09,1408,845,563,282,348,6.977,0.0,1.675,0.01
126,341378901,1,3.948,4.0,1.09,846,423,423,0,318,5.935,0.0,0.378,0.0
127,342463701,1,3.539,5.0,1.087,1204,602,602,0,458,4.846,0.0,0.0,0.0
128,342552501,1,1.296,2.0,1.055,598,299,299,0,223,0.642,0.0,0.119,0.0
129,344386601,78,3.325,6.0,0.83,823,436,387,49,266,5.118,0.01,1.81,0.03
130,345126301,1,1.209,1.0,0.787,320,160,160,0,122,0.742,0.0,0.0,0.0
131,345397901,1,1.394,2.0,1.007,900,450,450,0,340,0.605,0.0,0.0,0.0
132,346006301,406,4.503,6.0,1.07,1631,950,681,269,402,6.654,0.0,1.892,0.01
133,347058701,483,4.187,6.0,1.089,2230,1267,963,304,592,5.801,0.0,1.628,0.01
134,348560401,233,4.07,6.0,1.393,1877,1034,843,191,596,5.031,0.0,1.772,0.01
135,348606901,3,1.042,6.0,0.75,1582,791,791,0,590,0.508,0.0,0.234,0.0
136,351329101,487,4.242,6.0,1.142,2224,1273,951,322,596,5.734,0.0,1.718,0.0
137,353021501,1,1.38,2.0,0.935,444,222,222,0,161,0.641,0.0,0.253,0.0
139,356373201,1,3.912,5.0,1.01,1390,695,695,0,525,5.47,0.0,0.0,0.0
140,358732701,407,3.937,6.0,1.12,2107,1192,915,277,590,4.877,0.0,1.828,0.0
141,360465001,1,2.063,2.0,0.729,1592,796,796,0,596,2.009,0.0,0.0,0.0
142,364627301,455,4.242,6.0,1.208,2229,1247,982,265,591,5.744,0.0,1.672,0.01
143,365969701,251,3.858,6.0,0.863,1915,1041,874,167,592,5.958,0.0,1.766,0.0
144,368897601,205,4.669,6.0,1.267,733,459,274,185,189,5.276,0.0,1.739,0.01
145,370070501,1,3.436,4.0,1.236,1522,761,761,0,571,4.527,0.0,0.253,0.0
146,373885001,3,1.3,5.0,1.062,642,322,320,2,240,0.302,0.0,0.602,0.0
147,376055601,72,4.65,6.0,1.289,293,168,125,43,70,6.786,0.02,1.768,0.01
148,378981801,134,4.788,6.0,1.316,511,306,205,101,126,6.453,0.03,1.78,0.04
149,380010101,13,3.792,6.0,1.394,69,39,30,9,20,4.441,0.06,0.988,0.08
150,380172301,152,2.56,6.0,0.86,1735,932,803,129,590,3.185,0.0,1.723,0.03
151,385043601,1,3.42,4.0,0.986,1496,748,748,0,564,4.978,0.0,0.253,0.0
152,386517601,1,1.995,2.0,1.007,1411,706,705,1,529,1.854,0.0,0.0,0.0
154,389872601,363,4.532,6.0,1.075,2033,1139,894,245,591,6.086,0.0,1.716,0.01
155,395191801,4,3.634,6.0,1.134,1315,658,657,1,493,4.853,0.0,1.072,0.0
156,395575601,1,3.006,3.0,1.567,1148,574,574,0,418,3.01,0.0,0.169,0.0
157,398396501,444,4.058,6.0,1.019,2185,1231,954,277,592,5.572,0.0,1.64,0.01
159,398553001,1,1.531,2.0,0.999,1586,793,793,0,595,1.063,0.0,0.0,0.0
161,400578401,1,1.171,1.0,0.849,826,413,413,0,309,0.272,0.0,0.0,0.0
162,401584801,1,1.7,2.0,0.96,1612,806,806,0,595,1.637,0.0,0.0,0.0
163,401846601,262,4.601,6.0,0.988,1152,675,477,198,312,6.893,0.0,1.656,0.0
164,402248101,97,3.326,6.0,1.028,1709,885,824,61,595,4.855,0.0,1.724,0.02
166,406566101,1,2.126,3.0,0.911,1594,797,797,0,593,1.875,0.0,0.0,0.0
167,406603701,1,3.6,4.0,1.376,1590,795,795,0,596,4.867,0.0,0.0,0.0
168,408721401,80,2.201,6.0,0.664,1082,569,513,56,375,2.746,0.0,1.54,0.01
169,408855301,398,4.741,6.0,0.951,1715,986,729,257,441,6.853,0.0,1.835,0.0
170,409305601,1,1.177,1.0,0.951,886,443,443,0,334,0.549,0.0,0.0,0.0
171,409319701,3,1.621,5.0,0.854,1596,798,798,0,592,1.003,0.0,0.207,0.0
172,409470301,409,4.235,6.0,0.841,2091,1199,892,307,590,5.859,0.0,1.744,0.01
173,410577001,1,1.364,2.0,1.101,1618,809,809,0,595,0.199,0.0,0.016,0.0
174,410979301,492,4.652,6.0,0.93,2078,1198,880,318,532,6.424,0.01,1.754,0.01
175,411238201,1,1.43,2.0,1.207,1460,730,730,0,539,0.419,0.0,0.184,0.0
176,412116801,1,3.514,4.0,1.516,410,205,205,0,152,4.958,0.0,0.101,0.0
177,412341901,1,3.478,4.0,1.178,803,402,401,1,300,4.917,0.0,0.0,0.0
179,416619601,172,4.597,6.0,0.93,790,464,326,138,221,6.464,0.0,1.763,0.01
180,416927301,1,1.774,2.0,1.47,338,169,169,0,121,0.751,0.0,0.119,0.0
181,417545801,206,3.526,6.0,1.024,1912,1010,902,108,594,5.239,0.0,1.619,0.02
182,417865101,1,1.663,2.0,1.548,216,108,108,0,82,0.732,0.0,0.169,0.0
183,418308401,1,1.158,2.0,0.764,1506,753,753,0,560,0.207,0.0,0.07,0.0
184,418401701,1,1.654,2.0,0.776,1576,788,788,0,594,1.632,0.0,0.0,0.0
185,419089101,1,4.171,5.0,1.088,844,422,422,0,319,5.922,0.0,0.202,0.0
186,421152101,219,4.738,6.0,1.094,1230,692,538,154,359,7.318,0.0,1.655,0.01
187,423938701,157,4.098,6.0,1.225,1337,724,613,111,424,5.448,0.0,1.815,0.02
188,424387101,1,1.524,5.0,1.089,448,224,224,0,166,1.455,0.0,0.253,0.0
189,428923101,1,1.944,2.0,1.106,320,160,160,0,121,2.005,0.0,0.0,0.0
190,430884601,395,4.314,6.0,1.084,2180,1198,982,216,593,6.548,0.0,1.675,0.01
192,431390701,149,4.627,6.0,1.022,629,367,262,105,167,7.079,0.0,1.658,0.01
193,431815001,1,1.65,4.0,1.122,1556,778,778,0,590,0.952,0.0,0.705,0.0
195,433299001,1,3.777,4.0,1.825,358,179,179,0,130,4.998,0.0,0.504,0.0
197,435199201,1,1.32,2.0,0.734,1052,526,526,0,396,0.507,0.0,0.053,0.0
198,435713701,1,1.514,2.0,1.117,1580,790,790,0,593,0.406,0.0,0.036,0.0
199,436351801,34,2.512,6.0,0.742,1629,826,803,23,594,3.735,0.0,1.756,0.0
