,client_id,reconnections,lat_mean,lat_max,lat_min,total_msgs,out_msgs,in_msgs,lost_msgs,active_time,rtt_rmse,opt_rate,discovery_rmse,discovery_rate
0,177830201,340,3.913,5.0,0.65,1317,793,524,269,337,5.938,0.03,0.002,1.0
2,178483501,4,1.308,5.0,0.683,127,65,62,3,44,1.934,0.0,0.0,1.0
3,178885001,1,1.654,2.0,0.651,1572,786,786,0,590,2.004,0.0,0.0,1.0
4,181758601,1,1.59,2.0,0.651,528,264,264,0,199,1.924,0.0,0.0,1.0
5,182232701,327,2.875,5.0,0.65,1963,1112,851,261,591,3.47,0.01,0.006,0.97
7,183533601,258,4.05,5.0,0.65,944,581,363,218,242,5.787,0.04,0.004,1.0
8,184507401,263,4.12,5.0,0.65,958,591,367,224,247,5.914,0.05,0.0,1.0
9,185892901,321,3.696,5.0,0.651,1330,806,524,282,364,4.29,0.01,0.001,1.0
10,186028501,39,1.161,5.0,0.65,1632,834,798,36,592,0.722,0.0,0.0,1.0
11,186821501,106,2.479,5.0,0.65,844,467,377,90,267,2.511,0.02,0.004,0.99
12,187319101,44,3.668,5.0,0.65,152,96,56,40,38,6.434,0.0,0.0,1.0
13,187426001,195,4.333,5.0,0.651,676,425,251,174,170,5.854,0.02,0.003,0.99
14,187758401,138,1.81,5.0,0.65,1773,942,831,111,594,1.919,0.0,0.0,0.94
15,187781201,360,3.483,5.0,0.65,1637,968,669,299,462,4.384,0.02,0.005,0.99
16,189660101,1,1.506,2.0,0.651,677,339,338,1,256,1.777,0.0,0.0,1.0
17,189877301,11,0.968,5.0,0.65,511,260,251,9,190,1.018,0.0,0.0,1.0
18,192487201,1,1.403,2.0,0.651,860,430,430,0,326,1.611,0.0,0.0,1.0
19,195978501,272,4.039,5.0,0.65,990,616,374,242,254,5.42,0.05,0.001,1.0
20,196727701,1,0.994,5.0,0.852,868,434,434,0,323,0.777,0.0,0.0,1.0
21,199485101,124,4.042,5.0,0.65,447,276,171,105,110,6.02,0.06,0.002,0.99
22,199836701,237,4.064,5.0,0.65,872,535,337,198,226,5.965,0.04,0.003,0.94
23,200512301,377,3.369,5.0,0.65,1838,1081,757,324,531,3.668,0.02,0.001,1.0
24,202213001,40,1.127,5.0,0.65,1341,689,652,37,486,0.996,0.0,0.0,1.0
25,202911501,1,1.535,2.0,0.65,634,317,317,0,236,1.828,0.0,0.0,1.0
26,204654801,366,3.044,5.0,0.651,2028,1156,872,284,592,3.777,0.01,0.006,0.98
27,205014901,317,3.632,5.0,0.651,1370,818,552,266,372,4.487,0.0,0.001,1.0
28,206569901,207,4.136,5.0,0.65,738,461,277,184,193,5.628,0.04,0.0,1.0
29,207082401,369,3.298,5.0,0.65,1821,1063,758,305,527,3.939,0.01,0.001,0.99
30,208812001,1,1.696,2.0,0.65,354,177,177,0,133,2.122,0.0,0.0,1.0
31,210350901,116,4.093,5.0,0.65,414,259,155,104,107,5.885,0.08,0.004,0.99
32,210919601,40,1.538,5.0,0.652,647,341,306,35,225,1.294,0.0,0.0,1.0
33,212667701,364,3.063,5.0,0.65,2001,1149,852,297,593,3.522,0.01,0.003,0.99
34,212769701,157,4.345,5.0,0.65,530,340,190,150,140,4.899,0.0,0.004,0.99
35,214367601,1,1.725,2.0,0.65,312,156,156,0,119,2.177,0.0,0.0,1.0
36,217649401,307,2.718,5.0,0.65,1947,1095,852,243,590,3.345,0.01,0.003,1.0
37,217764201,367,3.278,5.0,0.65,1798,1046,752,294,509,4.131,0.03,0.006,0.98
38,218303001,315,2.769,5.0,0.65,1962,1114,848,266,594,2.886,0.0,0.007,0.99
39,218688101,335,3.225,5.0,0.65,1723,992,731,261,482,4.19,0.03,0.006,0.99
40,219468301,1,1.193,2.0,0.651,1454,727,727,0,544,1.275,0.0,0.0,1.0
41,219511701,317,3.012,5.0,0.65,1772,1024,748,276,530,3.127,0.0,0.003,0.99
42,219900501,329,3.461,5.0,0.65,1508,893,615,278,426,4.068,0.03,0.001,1.0
43,220699801,259,4.125,5.0,0.65,933,578,355,223,236,5.827,0.01,0.002,0.99
44,220961301,30,3.696,5.0,0.651,104,65,39,26,24,6.283,0.0,0.0,1.0
45,222570001,1,1.45,2.0,0.651,768,384,384,0,293,1.682,0.0,0.0,1.0
46,222993101,374,3.148,5.0,0.65,1999,1156,843,313,595,3.542,0.02,0.006,0.99
47,223048501,268,4.139,5.0,0.65,974,601,373,228,249,5.868,0.04,0.0,1.0
48,223120401,13,0.886,5.0,0.65,1588,799,789,10,591,0.669,0.0,0.0,1.0
49,223856401,317,3.756,5.0,0.651,1326,791,535,256,350,5.057,0.03,0.004,0.99
50,224397101,314,3.788,5.0,0.65,1289,778,511,267,352,4.621,0.02,0.0,1.0
51,226600001,1,1.273,5.0,0.672,1200,600,600,0,451,1.393,0.0,0.0,1.0
52,231526101,39,0.914,5.0,0.651,1624,829,795,34,591,0.704,0.0,0.0,1.0
53,232198601,360,3.054,5.0,0.65,1952,1120,832,288,565,3.744,0.02,0.0,1.0
55,235994101,206,4.047,5.0,0.65,737,460,277,183,194,5.33,0.06,0.003,1.0
56,236937001,55,4.142,5.0,0.651,181,117,64,53,47,5.025,0.0,0.0,1.0
57,240029901,357,3.174,5.0,0.65,1975,1130,845,285,591,3.941,0.01,0.002,1.0
58,240989701,213,4.167,5.0,0.651,762,476,286,190,203,5.705,0.0,0.004,0.98
59,242921301,120,4.313,5.0,0.65,398,256,142,114,104,4.769,0.05,0.0,1.0
60,245740201,332,2.813,5.0,0.65,1984,1133,851,282,592,2.912,0.01,0.002,1.0
61,247273001,316,4.11,5.0,0.65,1162,720,442,278,305,5.399,0.04,0.014,0.99
62,248044901,104,1.592,5.0,0.65,1704,897,807,90,591,1.474,0.0,0.0,1.0
63,253529101,317,2.736,5.0,0.65,1954,1114,840,274,596,2.744,0.0,0.004,0.99
64,256334601,206,4.313,5.0,0.651,722,451,271,180,181,6.136,0.03,0.002,1.0
65,257051801,4,0.959,5.0,0.651,1619,810,809,1,595,0.938,0.0,0.0,1.0
66,257872901,83,3.992,5.0,0.651,304,183,121,62,75,6.81,0.11,0.005,0.89
67,259827801,207,2.473,5.0,0.65,1634,908,726,182,519,2.303,0.0,0.0,1.0
68,261217901,79,4.222,5.0,0.652,255,166,89,77,66,4.945,0.0,0.005,0.99
69,262938201,61,3.928,5.0,0.65,212,134,78,56,55,5.162,0.0,0.0,1.0
70,263181301,1,1.057,3.0,0.651,308,154,154,0,115,1.04,0.01,0.0,1.0
71,266876301,355,4.125,5.0,0.65,1327,808,519,289,338,6.127,0.04,0.0,1.0
72,267044101,1,1.654,2.0,0.651,1566,783,783,0,591,2.003,0.0,0.0,1.0
73,267411001,271,4.216,5.0,0.65,960,600,360,240,245,5.9,0.04,0.007,0.99
74,268164901,331,3.767,5.0,0.65,1403,825,578,247,366,5.594,0.04,0.003,1.0
75,268192501,1,1.159,2.0,0.65,1582,791,791,0,595,1.226,0.0,0.0,1.0
76,269306201,367,3.769,5.0,0.65,1526,918,608,310,421,4.803,0.02,0.006,0.99
77,270552801,18,0.937,5.0,0.65,1298,657,641,16,484,0.825,0.0,0.0,1.0
78,270862901,201,4.074,5.0,0.651,732,452,280,172,191,5.843,0.05,0.001,1.0
79,271207601,16,1.578,5.0,0.65,257,134,123,11,87,2.18,0.02,0.0,1.0
80,271501201,374,3.618,5.0,0.651,1642,974,668,306,449,4.627,0.03,0.005,0.99
81,271671501,318,3.467,5.0,0.65,1442,850,592,258,404,4.413,0.02,0.002,1.0
82,273687001,5,1.993,5.0,0.651,18,11,7,4,5,0.602,0.0,0.0,1.0
83,274252701,1,1.157,2.0,0.651,1598,799,799,0,595,1.22,0.0,0.0,1.0
84,275473701,16,1.608,5.0,0.65,249,131,118,13,88,1.898,0.0,0.0,1.0
85,282893001,247,2.434,5.0,0.65,1848,1034,814,220,590,2.089,0.01,0.003,0.99
86,283237601,179,4.097,5.0,0.65,635,395,240,155,158,5.979,0.08,0.0,1.0
87,284492401,16,0.868,5.0,0.651,1621,818,803,15,592,0.482,0.0,0.0,1.0
88,285373201,366,4.049,5.0,0.65,1373,837,536,301,353,5.841,0.02,0.003,0.99
89,285391201,82,4.288,5.0,0.65,278,177,101,76,71,5.51,0.0,0.0,1.0
90,287074901,1,0.885,3.0,0.651,1574,787,787,0,593,0.661,0.0,0.0,1.0
91,287392801,6,1.673,5.0,0.651,1601,802,799,3,596,2.049,0.0,0.0,1.0
92,287882201,1,1.206,2.0,0.65,1392,696,696,0,524,1.294,0.0,0.0,1.0
94,291918801,368,3.561,5.0,0.65,1652,975,677,298,456,4.553,0.02,0.003,0.99
95,294077501,356,3.793,5.0,0.65,1465,874,591,283,391,5.421,0.02,0.006,0.99
96,294851801,4,0.819,5.0,0.651,1597,799,798,1,594,0.723,0.0,0.0,1.0
97,295786301,357,4.101,5.0,0.65,1311,805,506,299,336,6.029,0.05,0.002,1.0
98,295832401,106,2.518,5.0,0.65,695,397,298,99,220,2.099,0.01,0.004,0.99
99,296967301,359,3.03,5.0,0.65,2009,1149,860,289,592,3.668,0.01,0.003,0.99
100,297260101,239,4.319,5.0,0.65,817,517,300,217,208,5.702,0.05,0.002,1.0
101,298719001,197,4.26,5.0,0.651,666,427,239,188,175,4.771,0.0,0.0,1.0
102,303018401,357,2.996,5.0,0.65,2035,1145,890,255,591,4.204,0.02,0.003,0.93
103,303502201,353,3.034,5.0,0.651,1992,1132,860,272,583,3.938,0.02,0.003,0.99
104,305705001,362,3.064,5.0,0.65,1991,1147,844,303,591,3.435,0.01,0.002,1.0
105,311266501,111,1.524,5.0,0.65,1700,902,798,104,593,1.227,0.0,0.0,1.0
106,312987901,369,3.048,5.0,0.65,2048,1161,887,274,595,4.056,0.03,0.002,0.99
107,313099201,354,3.456,5.0,0.65,1687,975,712,263,468,4.922,0.03,0.002,1.0
108,313599001,343,4.182,5.0,0.65,1265,776,489,287,320,6.035,0.03,0.0,1.0
109,314610001,14,0.963,5.0,0.651,811,412,399,13,295,1.029,0.0,0.0,1.0
110,316062301,352,3.394,5.0,0.65,1659,966,693,273,463,4.622,0.03,0.0,1.0
111,317049401,178,3.97,5.0,0.651,663,406,257,149,170,5.872,0.04,0.0,1.0
112,319360201,106,4.047,5.0,0.651,370,233,137,96,97,5.446,0.03,0.0,1.0
113,321259701,1,1.057,4.0,0.653,566,283,283,0,212,0.975,0.0,0.0,1.0
114,323653801,371,3.012,5.0,0.65,2040,1166,874,292,591,3.727,0.02,0.003,0.99
115,323793801,287,4.028,5.0,0.651,1048,648,400,248,271,5.516,0.02,0.004,0.99
116,324962901,3,0.836,5.0,0.651,1126,564,562,2,427,0.665,0.0,0.0,1.0
117,325995301,348,2.914,5.0,0.65,1998,1146,852,294,590,3.141,0.01,0.001,1.0
118,328599801,312,2.781,5.0,0.65,1946,1101,845,256,595,3.136,0.01,0.015,0.99
119,328792801,369,2.973,5.0,0.65,2032,1165,867,298,596,3.509,0.01,0.0,1.0
120,331554501,284,4.191,5.0,0.65,1032,635,397,238,262,6.041,0.04,0.006,0.99
121,332552101,1,1.032,4.0,0.651,996,498,498,0,377,0.96,0.0,0.0,1.0
122,333665401,1,0.799,5.0,0.652,1566,783,783,0,591,0.595,0.0,0.0,1.0
123,334480801,321,3.605,5.0,0.651,1414,838,576,262,384,4.813,0.03,0.004,0.99
124,340860901,366,3.592,5.0,0.65,1669,974,695,279,458,4.971,0.04,0.003,0.99
125,340955901,367,4.043,5.0,0.65,1362,834,528,306,348,5.825,0.05,0.003,0.99
126,341378901,333,4.062,5.0,0.65,1221,755,466,289,318,5.641,0.03,0.0,1.0
127,342463701,318,3.202,5.0,0.65,1560,919,641,278,458,3.433,0.02,0.004,0.99
128,342552501,258,4.345,5.0,0.65,869,556,313,243,223,5.132,0.0,0.0,1.0
129,344386601,281,4.109,5.0,0.65,1034,639,395,244,266,5.674,0.03,0.003,0.99
130,345126301,134,4.268,5.0,0.65,465,293,172,121,122,6.391,0.05,0.003,0.99
131,345397901,322,3.938,5.0,0.651,1267,771,496,275,340,5.095,0.01,0.003,0.99
132,346006301,220,2.951,5.0,0.65,1323,764,559,205,402,2.217,0.0,0.003,1.0
133,347058701,375,3.07,5.0,0.65,1995,1159,836,323,592,3.289,0.01,0.002,0.99
134,348560401,336,2.853,5.0,0.65,1992,1137,855,282,596,3.132,0.01,0.003,0.99
135,348606901,209,2.347,5.0,0.65,1804,997,807,190,590,1.944,0.0,0.0,1.0
136,351329101,56,1.239,5.0,0.651,1629,842,787,55,596,0.547,0.0,0.009,0.96
137,353021501,46,1.736,5.0,0.651,491,267,224,43,161,1.601,0.01,0.0,1.0
139,356373201,376,3.312,5.0,0.65,1822,1070,752,318,525,3.806,0.01,0.003,0.99
140,358732701,313,2.779,5.0,0.651,1932,1098,834,264,590,2.974,0.01,0.0,1.0
141,360465001,47,1.102,5.0,0.65,1640,842,798,44,596,0.874,0.0,0.147,0.98
142,364627301,353,2.932,5.0,0.65,1981,1145,836,309,591,2.955,0.01,0.002,1.0
143,365969701,313,2.726,5.0,0.65,1956,1103,853,250,592,3.338,0.01,0.005,0.99
144,368897601,214,4.263,5.0,0.65,744,468,276,192,189,5.779,0.05,0.002,0.99
145,370070501,378,3.117,5.0,0.65,1955,1138,817,321,571,3.392,0.01,0.0,1.0
146,373885001,259,4.119,5.0,0.65,919,578,341,237,240,5.267,0.01,0.001,1.0
147,376055601,1,1.64,2.0,0.651,194,97,97,0,70,1.999,0.01,0.0,1.0
148,378981801,4,1.413,5.0,0.651,350,176,174,2,126,1.84,0.01,0.0,1.0
149,380010101,24,4.398,5.0,0.651,76,50,26,24,20,6.838,0.0,0.0,1.0
150,380172301,376,3.095,5.0,0.65,1992,1156,836,320,590,3.38,0.01,0.0,1.0
151,385043601,348,3.05,5.0,0.65,1904,1095,809,286,564,3.514,0.0,0.0,1.0
152,386517601,31,1.183,5.0,0.65,1447,736,711,25,529,1.177,0.0,0.0,1.0
154,389872601,375,3.128,5.0,0.65,1988,1151,837,314,591,3.478,0.01,0.004,0.99
155,395191801,342,3.27,5.0,0.65,1688,996,692,304,493,3.367,0.01,0.002,1.0
156,395575601,335,3.604,5.0,0.651,1566,908,658,250,418,5.138,0.02,0.003,0.99
157,398396501,332,2.812,5.0,0.65,1951,1119,832,287,592,2.951,0.01,0.005,0.98
159,398553001,333,2.835,5.0,0.65,1953,1125,828,297,595,2.686,0.0,0.004,0.99
161,400578401,325,4.102,5.0,0.65,1200,737,463,274,309,5.725,0.01,0.004,0.99
162,401584801,1,1.159,2.0,0.651,1612,806,806,0,595,1.225,0.0,0.0,1.0
163,401846601,321,4.023,5.0,0.65,1200,734,466,268,312,5.814,0.06,0.001,1.0
164,402248101,1,1.164,2.0,0.651,1578,789,789,0,595,1.237,0.0,0.0,1.0
166,406566101,330,2.803,5.0,0.65,1967,1126,841,285,593,2.845,0.01,0.0,1.0
167,406603701,14,1.021,5.0,0.651,1605,808,797,11,596,0.911,0.0,0.0,1.0
168,408721401,347,3.889,5.0,0.65,1368,836,532,304,375,4.603,0.04,0.0,1.0
169,408855301,356,3.531,5.0,0.65,1614,944,670,274,441,4.913,0.02,0.006,0.99
170,409305601,306,3.809,5.0,0.65,1239,748,491,257,334,4.984,0.01,0.0,1.0
171,409319701,353,2.952,5.0,0.65,1994,1148,846,302,592,3.151,0.01,0.004,0.99
172,409470301,314,2.776,5.0,0.651,1940,1104,836,268,590,2.807,0.01,0.0,1.0
173,410577001,1,1.156,2.0,0.651,1618,809,809,0,595,1.218,0.0,0.0,1.0
174,410979301,348,3.184,5.0,0.651,1809,1054,755,299,532,3.405,0.01,0.0,1.0
175,411238201,369,3.155,5.0,0.65,1903,1098,805,293,539,3.98,0.03,0.001,1.0
176,412116801,165,4.103,5.0,0.65,603,369,234,135,152,6.291,0.03,0.002,0.93
177,412341901,1,1.439,2.0,0.651,803,402,401,1,300,1.665,0.0,0.0,1.0
179,416619601,245,4.251,5.0,0.65,857,537,320,217,221,5.95,0.05,0.002,0.99
180,416927301,141,4.11,5.0,0.651,493,309,184,125,121,5.652,0.05,0.0,1.0
181,417545801,345,2.907,5.0,0.65,2055,1149,906,243,594,4.181,0.01,0.003,0.99
182,417865101,94,4.158,5.0,0.651,311,201,110,91,82,4.156,0.0,0.004,0.98
183,418308401,366,3.081,5.0,0.65,1945,1118,827,291,560,3.859,0.02,0.001,1.0
184,418401701,367,3.041,5.0,0.65,2019,1154,865,289,594,3.771,0.02,0.014,0.99
185,419089101,322,4.024,5.0,0.65,1206,743,463,280,319,5.2,0.01,0.002,1.0
186,421152101,341,3.884,5.0,0.65,1334,814,520,294,359,4.986,0.02,0.002,1.0
187,423938701,317,3.303,5.0,0.65,1508,884,624,260,424,4.097,0.02,0.001,1.0
188,424387101,189,4.291,5.0,0.65,659,412,247,165,166,5.872,0.03,0.0,1.0
189,428923101,136,4.266,5.0,0.65,481,295,186,109,121,6.748,0.02,0.0,0.96
190,430884601,1,0.995,2.0,0.65,1608,804,804,0,593,0.845,0.0,0.0,1.0
192,431390701,181,4.248,5.0,0.65,646,399,247,152,167,6.483,0.08,0.004,0.98
193,431815001,5,0.67,5.0,0.65,1560,782,778,4,590,0.025,0.0,0.0,1.0
195,433299001,144,4.08,5.0,0.651,525,322,203,119,130,6.475,0.1,0.022,0.95
197,435199201,363,3.902,5.0,0.65,1472,888,584,304,396,5.19,0.01,0.006,0.99
198,435713701,46,1.182,5.0,0.651,1627,835,792,43,593,0.761,0.0,0.0,1.0
199,436351801,369,3.079,5.0,0.65,2025,1161,864,297,594,3.665,0.01,0.0,1.0
200,436895901,51,1.222,5.0,0.651,1640,845,795,50,590,0.517,0.0,0.0,1.0
201,437307501,1,1.201,3.0,0.65,144,72,72,0,50,1.3,0.0,0.0,1.0
202,437657601,267,4.213,5.0,0.65,932,586,346,240,242,5.469,0.06,0.002,1.0
203,440385601,366,3.06,5.0,0.65,2039,1158,881,277,594,4.031,0.02,0.004,0.94
205,440756201,1,1.16,2.0,0.651,1566,783,783,0,594,1.228,0.0,0.0,1.0
206,442098401,376,3.061,5.0,0.65,2022,1171,851,320,592,3.232,0.01,0.003,0.99
207,446692801,1,1.853,2.0,0.651,106,53,53,0,37,2.454,0.0,0.0,1.0
208,447728401,46,1.197,5.0,0.65,1637,840,797,43,594,0.693,0.0,0.015,0.96
209,448184801,3,0.889,5.0,0.65,1600,801,799,2,596,0.63,0.0,0.0,1.0
210,448476301,353,2.943,5.0,0.65,2000,1151,849,302,596,3.131,0.02,0.003,0.99
211,451431601,379,3.126,5.0,0.65,2009,1167,842,325,592,3.289,0.01,0.002,0.99
