,client_id,reconnections,lat_mean,lat_max,lat_min,total_msgs,out_msgs,in_msgs,lost_msgs,active_time,rtt_rmse,opt_rate,discovery_rmse,discovery_rate
0,177830201,1,3.368,5.0,0.795,908,454,454,0,337,5.963,0.0,0.099,0.0
2,178483501,4,3.082,5.0,0.686,128,65,63,2,44,5.398,0.0,1.472,0.0
3,178885001,18,0.855,5.0,0.65,1592,803,789,14,590,0.857,0.0,1.606,0.06
4,181758601,5,1.58,5.0,0.651,534,268,266,2,199,1.998,0.0,1.806,0.0
5,182232701,3,0.884,5.0,0.707,1576,788,788,0,591,0.687,0.0,0.437,0.33
7,183533601,1,1.709,3.0,0.651,647,324,323,1,242,2.239,0.0,0.0,0.0
8,184507401,5,1.4,5.0,0.729,664,333,331,2,247,1.59,0.0,1.922,0.2
9,185892901,1,3.204,5.0,1.28,972,486,486,0,364,5.724,0.0,0.334,0.0
10,186028501,13,0.88,5.0,0.651,1607,808,799,9,592,0.877,0.0,1.446,0.0
11,186821501,1,2.106,5.0,0.904,723,362,361,1,267,3.166,0.0,0.099,0.0
12,187319101,13,2.336,5.0,0.65,119,65,54,11,38,4.032,0.02,2.125,0.08
13,187426001,8,1.06,5.0,0.651,469,238,231,7,170,0.757,0.01,1.537,0.12
14,187758401,1,1.627,5.0,0.65,1610,805,805,0,594,2.296,0.0,0.064,0.0
15,187781201,4,1.449,5.0,0.651,1223,612,611,1,462,1.866,0.0,3.018,0.0
16,189660101,11,1.783,5.0,0.65,689,349,340,9,256,2.365,0.0,2.002,0.0
17,189877301,11,0.958,5.0,0.65,513,260,253,7,190,1.327,0.0,0.895,0.0
18,192487201,1,1.214,2.0,0.651,860,430,430,0,326,1.334,0.0,0.001,0.0
19,195978501,1,1.681,4.0,0.697,689,345,344,1,254,2.222,0.0,0.0,1.0
20,196727701,1,3.147,3.0,0.651,868,434,434,0,323,4.995,0.0,0.504,0.0
21,199485101,8,1.422,5.0,0.77,316,160,156,4,110,1.823,0.0,1.92,0.0
22,199836701,1,2.148,2.0,0.65,598,299,299,0,226,2.99,0.0,0.169,0.0
23,200512301,14,1.003,5.0,0.651,1427,718,709,9,531,1.022,0.0,1.273,0.07
24,202213001,1,1.197,4.0,0.852,1300,650,650,0,486,1.91,0.0,0.332,0.0
25,202911501,6,1.04,5.0,0.65,641,322,319,3,236,1.127,0.01,1.178,0.17
26,204654801,13,0.938,5.0,0.651,1598,803,795,8,592,1.024,0.0,1.439,0.0
27,205014901,11,1.303,5.0,0.651,1016,512,504,8,372,1.412,0.0,2.099,0.0
28,206569901,4,2.3,3.0,0.835,513,258,255,3,193,3.604,0.0,1.822,0.0
29,207082401,1,2.352,5.0,0.836,1390,695,695,0,527,4.526,0.0,0.583,0.0
30,208812001,1,1.648,2.0,0.651,354,177,177,0,133,1.979,0.0,0.001,0.0
31,210350901,20,1.424,5.0,0.65,310,163,147,16,107,2.032,0.0,1.772,0.0
32,210919601,1,1.651,2.0,0.652,604,302,302,0,225,1.992,0.0,0.0,0.0
33,212667701,10,0.905,5.0,0.651,1581,795,786,9,593,0.524,0.0,0.888,0.0
34,212769701,1,1.995,4.0,0.819,368,184,184,0,140,3.396,0.0,0.332,0.0
35,214367601,18,1.333,5.0,0.651,332,173,159,14,119,1.883,0.0,1.019,0.0
36,217649401,10,1.224,5.0,0.819,1590,798,792,6,590,1.356,0.0,1.994,0.0
37,217764201,6,1.384,5.0,0.65,1366,685,681,4,509,1.761,0.0,1.435,0.0
38,218303001,1,2.188,5.0,0.676,1600,800,800,0,594,4.292,0.0,0.145,0.0
39,218688101,2,1.355,5.0,0.651,1318,659,659,0,482,2.021,0.0,1.064,0.0
40,219468301,1,1.692,5.0,0.651,1454,727,727,0,544,2.435,0.0,0.001,0.0
41,219511701,1,2.493,5.0,0.903,1416,708,708,0,530,4.768,0.0,0.099,0.0
42,219900501,7,0.958,5.0,0.721,1142,571,571,0,426,1.165,0.0,1.347,0.14
43,220699801,8,1.495,5.0,0.65,651,327,324,3,236,1.899,0.0,1.774,0.0
44,220961301,5,2.201,5.0,0.651,78,40,38,2,24,3.928,0.0,0.537,0.0
45,222570001,3,0.908,5.0,0.651,772,386,386,0,293,0.962,0.0,2.01,0.0
46,222993101,14,0.937,5.0,0.651,1582,796,786,10,595,0.85,0.0,2.468,0.0
47,223048501,11,1.809,5.0,0.903,683,344,339,5,249,2.535,0.0,0.736,0.09
48,223120401,8,0.734,5.0,0.65,1584,794,790,4,591,0.689,0.02,2.02,0.12
49,223856401,5,1.326,5.0,0.721,957,479,478,1,350,1.548,0.0,2.525,0.0
50,224397101,1,1.527,4.0,0.65,930,465,465,0,352,1.95,0.01,0.0,1.0
51,226600001,1,1.061,2.0,0.651,1200,600,600,0,451,1.134,0.0,0.001,0.0
52,231526101,8,1.281,5.0,0.809,1589,798,791,7,591,1.52,0.0,1.84,0.0
53,232198601,1,1.307,4.0,0.819,1522,761,761,0,565,1.594,0.0,0.0,1.0
55,235994101,1,2.294,3.0,0.65,509,255,254,1,194,3.608,0.0,0.0,0.0
56,236937001,8,1.124,5.0,0.652,133,70,63,7,47,0.587,0.05,0.787,0.12
57,240029901,3,1.267,3.0,0.809,1550,776,774,2,591,1.52,0.0,2.001,0.0
58,240989701,1,0.651,1.0,0.651,528,264,264,0,203,0.069,0.0,0.001,0.0
59,242921301,3,1.637,2.0,0.735,276,139,137,2,104,1.968,0.0,0.569,0.0
60,245740201,3,1.644,5.0,0.752,1606,804,802,2,592,2.347,0.0,0.586,0.0
61,247273001,19,0.811,5.0,0.65,828,423,405,18,305,0.765,0.48,1.618,0.0
62,248044901,1,2.223,5.0,0.795,1588,794,794,0,591,4.359,0.0,1.71,0.0
63,253529101,13,1.115,5.0,0.65,1611,810,801,9,596,1.202,0.0,1.314,0.0
64,256334601,1,1.349,2.0,0.651,492,246,246,0,181,1.565,0.0,0.001,0.0
65,257051801,1,2.187,5.0,0.651,1614,807,807,0,595,4.283,0.0,0.0,0.0
66,257872901,4,2.099,3.0,0.82,205,104,101,3,75,3.037,0.0,0.886,0.0
67,259827801,18,1.382,5.0,0.651,1426,719,707,12,519,1.812,0.0,1.796,0.06
68,261217901,5,2.276,5.0,0.753,181,92,89,3,66,3.31,0.0,1.082,0.0
69,262938201,4,3.028,5.0,0.779,153,77,76,1,55,5.344,0.0,2.017,0.0
70,263181301,2,1.716,5.0,0.652,310,155,155,0,115,2.341,0.0,0.331,0.0
71,266876301,8,1.61,5.0,0.651,917,461,456,5,338,2.104,0.0,2.576,0.0
72,267044101,7,0.87,5.0,0.651,1572,789,783,6,591,0.519,0.0,0.716,0.0
73,267411001,1,1.717,3.0,0.676,660,330,330,0,245,2.248,0.0,0.026,0.0
74,268164901,2,3.155,5.0,0.905,992,496,496,0,366,5.653,0.0,2.834,0.0
75,268192501,1,2.288,3.0,0.651,1582,791,791,0,595,3.796,0.0,0.0,0.0
76,269306201,1,2.8,3.0,0.651,1104,552,552,0,421,4.485,0.0,0.0,0.0
77,270552801,3,1.26,5.0,0.65,1283,642,641,1,484,1.436,0.0,0.583,0.0
78,270862901,1,1.646,2.0,0.651,504,252,252,0,191,1.983,0.0,0.001,0.0
79,271207601,5,1.299,5.0,0.651,244,123,121,2,87,1.745,0.0,0.456,0.0
80,271501201,1,0.914,1.0,0.669,1202,601,601,0,449,0.528,0.0,0.0,0.0
81,271671501,1,1.51,5.0,0.752,1066,533,533,0,404,2.332,0.0,0.358,0.0
82,273687001,1,1.394,3.0,0.652,14,7,7,0,5,2.276,0.0,0.0,0.0
83,274252701,1,1.327,2.0,0.651,1598,799,799,0,595,1.539,0.0,0.0,0.0
84,275473701,1,3.04,3.0,0.651,232,116,116,0,88,4.84,0.0,0.207,0.0
85,282893001,11,0.778,5.0,0.651,1589,798,791,7,590,0.719,0.0,1.195,0.09
86,283237601,1,2.126,5.0,0.651,434,217,217,0,158,3.492,0.0,0.001,0.0
87,284492401,1,0.863,2.0,0.651,1606,803,803,0,592,0.857,0.0,0.001,0.0
88,285373201,9,1.016,5.0,0.65,956,480,476,4,353,1.188,0.0,2.244,0.11
89,285391201,1,2.801,4.0,0.65,192,96,96,0,71,4.708,0.0,0.0,0.0
90,287074901,1,1.115,4.0,0.651,1574,787,787,0,593,1.726,0.0,0.0,0.0
91,287392801,19,1.247,5.0,0.651,1617,815,802,13,596,1.436,0.0,1.723,0.05
92,287882201,1,2.369,5.0,0.714,1392,696,696,0,524,4.556,0.0,0.0,0.0
94,291918801,21,0.876,5.0,0.651,1238,628,610,18,456,0.637,0.0,1.973,0.05
95,294077501,5,0.978,5.0,0.652,1043,523,520,3,391,0.83,0.0,1.354,0.0
96,294851801,10,1.117,5.0,0.652,1605,805,800,5,594,1.208,0.0,1.952,0.0
97,295786301,1,0.929,2.0,0.683,898,449,449,0,336,0.595,0.01,0.033,0.0
98,295832401,7,1.115,5.0,0.672,591,298,293,5,220,1.265,0.01,1.84,0.14
99,296967301,3,0.936,5.0,0.73,1586,793,793,0,592,0.806,0.0,2.02,0.0
100,297260101,1,1.759,4.0,0.723,558,279,279,0,208,2.395,0.0,0.0,1.0
101,298719001,3,1.824,5.0,0.65,466,233,233,0,175,2.558,0.0,0.563,0.0
102,303018401,16,0.846,5.0,0.65,1594,804,790,14,591,0.61,0.27,1.888,0.0
103,303502201,7,1.346,5.0,0.651,1569,786,783,3,583,2.141,0.0,1.586,0.14
104,305705001,1,1.255,3.0,0.735,1572,786,786,0,591,1.503,0.0,0.007,0.0
105,311266501,17,1.329,5.0,0.65,1603,808,795,13,593,1.642,0.0,1.985,0.0
106,312987901,3,0.878,5.0,0.651,1590,795,795,0,595,0.671,0.0,0.255,0.33
107,313099201,1,0.91,1.0,0.729,1244,622,622,0,468,0.522,0.01,0.01,0.0
108,313599001,1,3.254,5.0,0.752,868,434,434,0,320,5.884,0.0,0.404,0.0
109,314610001,20,1.049,5.0,0.65,819,418,401,17,295,1.053,0.0,1.517,0.0
110,316062301,3,0.94,5.0,0.729,1234,617,617,0,463,0.879,0.0,0.632,0.0
111,317049401,7,1.145,5.0,0.651,469,235,234,1,170,1.556,0.0,2.246,0.14
112,319360201,1,2.452,4.0,0.905,256,128,128,0,97,4.122,0.0,0.332,0.0
113,321259701,10,1.155,5.0,0.652,576,292,284,8,212,1.318,0.0,1.669,0.0
114,323653801,1,1.334,2.0,0.65,1592,796,796,0,591,1.549,0.0,0.207,0.0
115,323793801,10,0.852,5.0,0.651,734,371,363,8,271,0.793,0.0,0.9,0.0
116,324962901,3,0.922,5.0,0.687,1128,564,564,0,427,0.95,0.0,0.176,0.0
117,325995301,1,1.651,5.0,1.054,1598,799,799,0,590,2.349,0.0,0.099,0.0
118,328599801,7,1.289,5.0,0.651,1588,796,792,4,595,1.594,0.0,1.179,0.0
119,328792801,1,1.254,3.0,0.65,1594,797,797,0,596,1.515,0.0,0.0,0.0
120,331554501,1,1.657,4.0,0.65,704,352,352,0,262,2.195,0.02,0.0,1.0
121,332552101,1,1.547,5.0,0.651,996,498,498,0,377,2.342,0.0,0.145,0.0
122,333665401,16,1.623,5.0,0.652,1584,798,786,12,591,2.162,0.0,1.861,0.0
123,334480801,1,1.54,5.0,0.651,1035,518,517,1,384,2.326,0.0,0.064,0.0
124,340860901,1,1.416,5.0,0.65,1218,609,609,0,458,2.165,0.0,0.001,0.0
125,340955901,1,1.521,3.0,0.752,936,468,468,0,348,1.934,0.0,0.073,0.0
126,341378901,1,3.224,5.0,0.752,846,423,423,0,318,5.835,0.0,0.404,0.0
127,342463701,3,1.497,3.0,0.689,1206,604,602,2,458,2.385,0.0,0.146,0.0
128,342552501,1,1.892,5.0,1.281,598,299,299,0,223,3.009,0.0,0.358,0.0
129,344386601,7,1.492,5.0,0.65,726,365,361,4,266,1.85,0.0,1.883,0.0
130,345126301,1,1.059,1.0,0.65,320,160,160,0,122,0.833,0.04,0.016,0.0
131,345397901,1,1.643,2.0,0.651,900,450,450,0,340,1.986,0.0,0.0,0.0
132,346006301,8,0.937,5.0,0.651,1097,552,545,7,402,0.551,0.0,0.965,0.0
133,347058701,5,1.307,5.0,0.779,1576,789,787,2,592,1.658,0.0,0.69,0.0
134,348560401,1,2.318,5.0,0.651,1604,802,802,0,596,4.518,0.0,0.0,0.0
135,348606901,4,0.913,5.0,0.651,1582,792,790,2,590,0.697,0.0,0.748,0.0
136,351329101,3,1.296,5.0,0.651,1578,789,789,0,596,1.623,0.0,0.147,0.0
137,353021501,1,4.561,5.0,0.752,444,222,222,0,161,7.884,0.0,0.357,0.0
139,356373201,1,2.479,3.0,0.65,1390,695,695,0,525,4.046,0.0,0.0,0.0
140,358732701,13,1.222,5.0,0.777,1586,798,788,10,590,1.305,0.0,2.095,0.0
141,360465001,1,1.479,2.0,0.65,1592,796,796,0,596,1.975,0.0,0.0,0.0
142,364627301,1,1.654,5.0,1.055,1586,793,793,0,591,2.369,0.0,0.099,0.0
143,365969701,5,1.331,5.0,0.651,1589,795,794,1,592,1.714,0.0,1.347,0.0
144,368897601,14,1.44,5.0,0.651,522,268,254,14,189,1.562,0.0,1.771,0.07
145,370070501,7,0.793,5.0,0.651,1530,767,763,4,571,0.812,0.0,1.487,0.14
146,373885001,10,0.864,5.0,0.65,652,329,323,6,240,1.153,0.01,0.884,0.2
147,376055601,13,1.589,5.0,0.651,211,109,102,7,70,2.855,0.01,1.958,0.08
148,378981801,3,1.206,5.0,0.651,349,175,174,1,126,1.452,0.0,0.297,0.0
149,380010101,1,3.268,5.0,0.651,54,27,27,0,20,6.245,0.0,0.001,0.0
150,380172301,1,2.335,5.0,0.795,1562,781,781,0,590,4.549,0.0,0.099,0.0
151,385043601,5,1.306,5.0,0.651,1502,752,750,2,564,1.64,0.0,0.623,0.0
152,386517601,1,1.177,2.0,0.65,1411,706,705,1,529,1.269,0.0,0.001,0.0
154,389872601,4,1.258,3.0,0.651,1557,780,777,3,591,1.496,0.0,0.21,0.0
155,395191801,1,1.61,2.0,1.155,1310,655,655,0,493,2.152,0.0,0.169,0.0
156,395575601,5,1.018,5.0,0.651,1154,578,576,2,418,0.957,0.0,0.828,0.0
157,398396501,8,2.298,5.0,0.651,1587,795,792,3,592,3.827,0.0,1.064,0.0
159,398553001,1,0.855,1.0,0.65,1586,793,793,0,595,0.472,0.01,0.0,0.0
161,400578401,5,0.977,5.0,0.651,831,417,414,3,309,0.989,0.0,0.611,0.0
162,401584801,1,1.478,2.0,0.651,1612,806,806,0,595,1.97,0.0,0.0,0.0
163,401846601,7,0.913,5.0,0.697,836,420,416,4,312,0.898,0.0,1.526,0.0
164,402248101,4,0.926,5.0,0.651,1582,792,790,2,595,0.72,0.0,0.983,0.0
166,406566101,1,2.314,5.0,0.714,1594,797,797,0,593,4.51,0.0,0.063,0.0
167,406603701,1,1.189,2.0,0.651,1590,795,795,0,596,1.293,0.0,0.0,0.0
168,408721401,5,1.017,5.0,0.65,985,494,491,3,375,0.915,0.0,0.665,0.0
169,408855301,1,0.898,2.0,0.702,1178,589,589,0,441,0.54,0.01,0.005,0.0
170,409305601,4,1.634,5.0,0.651,892,446,446,0,334,2.238,0.0,0.969,0.0
171,409319701,5,1.079,5.0,0.651,1598,800,798,2,592,1.091,0.0,1.926,0.0
172,409470301,8,1.106,5.0,0.777,1592,798,794,4,590,1.181,0.0,1.764,0.0
173,410577001,1,0.651,1.0,0.65,1618,809,809,0,595,0.038,0.0,0.0,0.0
174,410979301,1,0.894,1.0,0.687,1414,707,707,0,532,0.498,0.0,0.0,0.0
175,411238201,5,1.331,4.0,0.777,1464,734,730,4,539,1.608,0.0,1.611,0.0
176,412116801,1,4.578,5.0,0.795,410,205,205,0,152,7.916,0.0,0.145,0.0
177,412341901,1,3.565,5.0,0.651,803,402,401,1,300,6.279,0.0,0.0,0.0
179,416619601,1,3.891,5.0,0.65,586,293,293,0,221,6.857,0.0,0.0,0.0
180,416927301,6,1.225,5.0,0.651,344,174,170,4,121,1.321,0.0,0.841,0.0
181,417545801,1,0.878,1.0,0.65,1610,805,805,0,594,0.475,0.0,0.0,0.0
182,417865101,6,2.286,5.0,1.054,225,113,112,1,82,3.611,0.0,0.902,0.0
183,418308401,3,1.223,5.0,0.688,1510,755,755,0,560,1.375,0.0,2.941,0.0
184,418401701,1,1.099,4.0,0.65,1576,788,788,0,594,1.674,0.0,0.0,0.0
185,419089101,10,1.006,5.0,0.652,856,431,425,6,319,1.153,0.0,2.05,0.0
186,421152101,5,0.992,5.0,0.651,954,478,476,2,359,0.948,0.0,1.855,0.0
187,423938701,22,1.286,5.0,0.651,1160,589,571,18,424,1.447,0.0,2.019,0.0
188,424387101,6,0.927,5.0,0.696,456,229,227,2,166,1.307,0.0,1.406,0.0
189,428923101,1,1.053,1.0,0.65,320,160,160,0,121,0.826,0.03,0.0,0.0
190,430884601,1,1.334,3.0,0.65,1608,804,804,0,593,2.115,0.0,0.0,0.0
192,431390701,1,1.837,3.0,0.704,438,219,219,0,167,2.476,0.0,0.054,0.0
193,431815001,1,0.881,1.0,0.752,1556,778,778,0,590,0.478,0.0,0.032,0.0
195,433299001,1,2.586,5.0,0.796,358,179,179,0,130,4.089,0.0,0.099,0.0
197,435199201,7,1.527,5.0,0.65,1061,532,529,3,396,2.026,0.0,1.871,0.0
198,435713701,9,1.321,5.0,0.687,1590,798,792,6,593,1.615,0.0,2.206,0.0
199,436351801,1,0.879,1.0,0.65,1586,793,793,0,594,0.476,0.0,0.0,0.0
200,436895901,1,1.287,4.0,0.784,1590,795,795,0,590,1.567,0.0,0.0,1.0
201,437307501,10,1.656,5.0,0.65,156,81,75,6,50,2.621,0.02,1.431,0.0
202,437657601,27,1.258,5.0,0.651,670,346,324,22,242,1.42,0.0,1.83,0.0
203,440385601,6,0.974,5.0,0.651,1593,798,795,3,594,0.98,0.0,1.929,0.17
205,440756201,10,0.845,5.0,0.651,1577,792,785,7,594,0.713,0.0,0.778,0.0
206,442098401,1,2.297,3.0,0.688,1592,796,796,0,592,3.805,0.0,0.504,0.0
207,446692801,7,1.688,5.0,0.651,114,59,55,4,37,2.691,0.0,1.851,0.0
208,447728401,3,0.882,2.0,0.707,1592,797,795,2,594,0.476,0.0,0.156,0.0
209,448184801,1,1.114,2.0,0.651,1598,799,799,0,596,1.185,0.0,0.001,0.0
210,448476301,1,1.187,2.0,0.65,1598,799,799,0,596,1.289,0.0,0.0,0.0
211,451431601,11,1.211,5.0,0.65,1592,799,793,6,592,1.374,0.0,1.512,0.0
